PokerStars Game #69704749311: Tournament #544010396, $20+$2 USD Hold'em No Limit - Level II (15/30) - 2011/10/29 20:17:29 MSK [2011/10/29 12:17:29 ET]
Table '544010396 89' 9-max Seat #3 is the button
Seat 1: Fedayn72 (3275 in chips) 
Seat 2: vikim08 (2925 in chips) 
Seat 3: frankyhh_hh (3065 in chips) 
Seat 4: playnene (2970 in chips) 
Seat 5: Kurre1 (3055 in chips) 
Seat 6: ribolov01 (2995 in chips) 
Seat 7: 1LATESHOW1 (2925 in chips) 
Seat 8: malik_msk (3000 in chips) 
Seat 9: 2NDclass (5790 in chips) 
playnene: posts small blind 15
Kurre1: posts big blind 30
*** HOLE CARDS ***
Dealt to malik_msk [2c 9d]
ribolov01: folds 
1LATESHOW1: folds 
malik_msk: folds 
2NDclass: folds 
Fedayn72: folds 
vikim08: folds 
frankyhh_hh: folds 
playnene: raises 60 to 90
Kurre1: folds 
Uncalled bet (60) returned to playnene
playnene collected 60 from pot
playnene: doesn't show hand 
*** SUMMARY ***
Total pot 60 | Rake 0 
Seat 1: Fedayn72 folded before Flop (didn't bet)
Seat 2: vikim08 folded before Flop (didn't bet)
Seat 3: frankyhh_hh (button) folded before Flop (didn't bet)
Seat 4: playnene (small blind) collected (60)
Seat 5: Kurre1 (big blind) folded before Flop
Seat 6: ribolov01 folded before Flop (didn't bet)
Seat 7: 1LATESHOW1 folded before Flop (didn't bet)
Seat 8: malik_msk folded before Flop (didn't bet)
Seat 9: 2NDclass folded before Flop (didn't bet)



PokerStars Game #69704772047: Tournament #544010396, $20+$2 USD Hold'em No Limit - Level II (15/30) - 2011/10/29 20:17:55 MSK [2011/10/29 12:17:55 ET]
Table '544010396 89' 9-max Seat #4 is the button
Seat 1: Fedayn72 (3275 in chips) 
Seat 2: vikim08 (2925 in chips) 
Seat 3: frankyhh_hh (3065 in chips) 
Seat 4: playnene (3000 in chips) 
Seat 5: Kurre1 (3025 in chips) 
Seat 6: ribolov01 (2995 in chips) 
Seat 7: 1LATESHOW1 (2925 in chips) 
Seat 8: malik_msk (3000 in chips) 
Seat 9: 2NDclass (5790 in chips) 
Kurre1: posts small blind 15
ribolov01: posts big blind 30
*** HOLE CARDS ***
Dealt to malik_msk [4h Ts]
1LATESHOW1: folds 
malik_msk: calls 30
2NDclass: folds 
Fedayn72: folds 
vikim08: folds 
frankyhh_hh: folds 
playnene: folds 
Kurre1: folds 
ribolov01: checks 
*** FLOP *** [3c 4s 3h]
ribolov01: checks 
malik_msk: bets 30
ribolov01: folds 
Uncalled bet (30) returned to malik_msk
malik_msk collected 75 from pot
malik_msk: doesn't show hand 
*** SUMMARY ***
Total pot 75 | Rake 0 
Board [3c 4s 3h]
Seat 1: Fedayn72 folded before Flop (didn't bet)
Seat 2: vikim08 folded before Flop (didn't bet)
Seat 3: frankyhh_hh folded before Flop (didn't bet)
Seat 4: playnene (button) folded before Flop (didn't bet)
Seat 5: Kurre1 (small blind) folded before Flop
Seat 6: ribolov01 (big blind) folded on the Flop
Seat 7: 1LATESHOW1 folded before Flop (didn't bet)
Seat 8: malik_msk collected (75)
Seat 9: 2NDclass folded before Flop (didn't bet)



PokerStars Game #69704803653: Tournament #544010396, $20+$2 USD Hold'em No Limit - Level II (15/30) - 2011/10/29 20:18:33 MSK [2011/10/29 12:18:33 ET]
Table '544010396 89' 9-max Seat #5 is the button
Seat 1: Fedayn72 (3275 in chips) 
Seat 2: vikim08 (2925 in chips) 
Seat 3: frankyhh_hh (3065 in chips) 
Seat 4: playnene (3000 in chips) 
Seat 5: Kurre1 (3010 in chips) 
Seat 6: ribolov01 (2965 in chips) 
Seat 7: 1LATESHOW1 (2925 in chips) 
Seat 8: malik_msk (3045 in chips) 
Seat 9: 2NDclass (5790 in chips) 
ribolov01: posts small blind 15
1LATESHOW1: posts big blind 30
*** HOLE CARDS ***
Dealt to malik_msk [Ah 6h]
malik_msk: raises 30 to 60
2NDclass: calls 60
Fedayn72: folds 
vikim08: folds 
frankyhh_hh: folds 
playnene: folds 
Kurre1: folds 
ribolov01: folds 
1LATESHOW1: calls 30
*** FLOP *** [9h 9d Ac]
1LATESHOW1: checks 
malik_msk: bets 120
2NDclass: calls 120
1LATESHOW1: folds 
*** TURN *** [9h 9d Ac] [7s]
malik_msk: bets 330
2NDclass: calls 330
*** RIVER *** [9h 9d Ac 7s] [6c]
malik_msk: bets 780
2NDclass: calls 780
*** SHOW DOWN ***
malik_msk: shows [Ah 6h] (two pair, Aces and Nines)
2NDclass: shows [Ad Td] (two pair, Aces and Nines - Ten kicker)
2NDclass collected 2655 from pot
*** SUMMARY ***
Total pot 2655 | Rake 0 
Board [9h 9d Ac 7s 6c]
Seat 1: Fedayn72 folded before Flop (didn't bet)
Seat 2: vikim08 folded before Flop (didn't bet)
Seat 3: frankyhh_hh folded before Flop (didn't bet)
Seat 4: playnene folded before Flop (didn't bet)
Seat 5: Kurre1 (button) folded before Flop (didn't bet)
Seat 6: ribolov01 (small blind) folded before Flop
Seat 7: 1LATESHOW1 (big blind) folded on the Flop
Seat 8: malik_msk showed [Ah 6h] and lost with two pair, Aces and Nines
Seat 9: 2NDclass showed [Ad Td] and won (2655) with two pair, Aces and Nines



PokerStars Game #69704873353: Tournament #544010396, $20+$2 USD Hold'em No Limit - Level III (20/40) - 2011/10/29 20:19:56 MSK [2011/10/29 12:19:56 ET]
Table '544010396 89' 9-max Seat #6 is the button
Seat 1: Fedayn72 (3275 in chips) 
Seat 2: vikim08 (2925 in chips) 
Seat 3: frankyhh_hh (3065 in chips) 
Seat 4: playnene (3000 in chips) 
Seat 5: Kurre1 (3010 in chips) 
Seat 6: ribolov01 (2950 in chips) 
Seat 7: 1LATESHOW1 (2865 in chips) 
Seat 8: malik_msk (1755 in chips) 
Seat 9: 2NDclass (7155 in chips) 
1LATESHOW1: posts small blind 20
malik_msk: posts big blind 40
*** HOLE CARDS ***
Dealt to malik_msk [7s 4s]
2NDclass: folds 
Fedayn72: folds 
vikim08: folds 
frankyhh_hh: folds 
playnene: folds 
Kurre1: folds 
ribolov01: folds 
1LATESHOW1: raises 80 to 120
malik_msk: calls 80
*** FLOP *** [2c 4c 8c]
1LATESHOW1: bets 72
malik_msk: calls 72
*** TURN *** [2c 4c 8c] [Jh]
1LATESHOW1: bets 230
malik_msk: folds 
Uncalled bet (230) returned to 1LATESHOW1
1LATESHOW1 collected 384 from pot
*** SUMMARY ***
Total pot 384 | Rake 0 
Board [2c 4c 8c Jh]
Seat 1: Fedayn72 folded before Flop (didn't bet)
Seat 2: vikim08 folded before Flop (didn't bet)
Seat 3: frankyhh_hh folded before Flop (didn't bet)
Seat 4: playnene folded before Flop (didn't bet)
Seat 5: Kurre1 folded before Flop (didn't bet)
Seat 6: ribolov01 (button) folded before Flop (didn't bet)
Seat 7: 1LATESHOW1 (small blind) collected (384)
Seat 8: malik_msk (big blind) folded on the Turn
Seat 9: 2NDclass folded before Flop (didn't bet)



PokerStars Game #69704909240: Tournament #544010396, $20+$2 USD Hold'em No Limit - Level III (20/40) - 2011/10/29 20:20:39 MSK [2011/10/29 12:20:39 ET]
Table '544010396 89' 9-max Seat #7 is the button
Seat 1: Fedayn72 (3275 in chips) 
Seat 2: vikim08 (2925 in chips) 
Seat 3: frankyhh_hh (3065 in chips) 
Seat 4: playnene (3000 in chips) 
Seat 5: Kurre1 (3010 in chips) 
Seat 6: ribolov01 (2950 in chips) 
Seat 7: 1LATESHOW1 (3057 in chips) 
Seat 8: malik_msk (1563 in chips) 
Seat 9: 2NDclass (7155 in chips) 
malik_msk: posts small blind 20
2NDclass: posts big blind 40
*** HOLE CARDS ***
Dealt to malik_msk [7h Js]
Fedayn72: folds 
vikim08 has timed out
vikim08: folds 
vikim08 is sitting out
frankyhh_hh: folds 
vikim08 has returned
playnene: folds 
Kurre1: folds 
ribolov01: folds 
1LATESHOW1: folds 
malik_msk: calls 20
2NDclass: checks 
*** FLOP *** [Jd 2s Td]
malik_msk: checks 
2NDclass: checks 
*** TURN *** [Jd 2s Td] [7c]
malik_msk: bets 40
2NDclass: folds 
Uncalled bet (40) returned to malik_msk
malik_msk collected 80 from pot
malik_msk: doesn't show hand 
*** SUMMARY ***
Total pot 80 | Rake 0 
Board [Jd 2s Td 7c]
Seat 1: Fedayn72 folded before Flop (didn't bet)
Seat 2: vikim08 folded before Flop (didn't bet)
Seat 3: frankyhh_hh folded before Flop (didn't bet)
Seat 4: playnene folded before Flop (didn't bet)
Seat 5: Kurre1 folded before Flop (didn't bet)
Seat 6: ribolov01 folded before Flop (didn't bet)
Seat 7: 1LATESHOW1 (button) folded before Flop (didn't bet)
Seat 8: malik_msk (small blind) collected (80)
Seat 9: 2NDclass (big blind) folded on the Turn



PokerStars Game #69704985045: Tournament #544010396, $20+$2 USD Hold'em No Limit - Level III (20/40) - 2011/10/29 20:22:10 MSK [2011/10/29 12:22:10 ET]
Table '544010396 89' 9-max Seat #8 is the button
Seat 1: Fedayn72 (3275 in chips) 
Seat 2: vikim08 (2925 in chips) 
Seat 3: frankyhh_hh (3065 in chips) 
Seat 4: playnene (3000 in chips) 
Seat 5: Kurre1 (3010 in chips) 
Seat 6: ribolov01 (2950 in chips) 
Seat 7: 1LATESHOW1 (3057 in chips) 
Seat 8: malik_msk (1603 in chips) 
Seat 9: 2NDclass (7115 in chips) 
2NDclass: posts small blind 20
Fedayn72: posts big blind 40
*** HOLE CARDS ***
Dealt to malik_msk [6s 8s]
vikim08: folds 
frankyhh_hh: folds 
playnene: folds 
Kurre1: folds 
ribolov01: raises 60 to 100
1LATESHOW1: folds 
malik_msk: calls 100
2NDclass: folds 
Fedayn72: folds 
*** FLOP *** [Kd 4h As]
ribolov01: bets 119
malik_msk: folds 
Uncalled bet (119) returned to ribolov01
ribolov01 collected 260 from pot
ribolov01: doesn't show hand 
*** SUMMARY ***
Total pot 260 | Rake 0 
Board [Kd 4h As]
Seat 1: Fedayn72 (big blind) folded before Flop
Seat 2: vikim08 folded before Flop (didn't bet)
Seat 3: frankyhh_hh folded before Flop (didn't bet)
Seat 4: playnene folded before Flop (didn't bet)
Seat 5: Kurre1 folded before Flop (didn't bet)
Seat 6: ribolov01 collected (260)
Seat 7: 1LATESHOW1 folded before Flop (didn't bet)
Seat 8: malik_msk (button) folded on the Flop
Seat 9: 2NDclass (small blind) folded before Flop



PokerStars Game #69705036922: Tournament #544010396, $20+$2 USD Hold'em No Limit - Level III (20/40) - 2011/10/29 20:23:12 MSK [2011/10/29 12:23:12 ET]
Table '544010396 89' 9-max Seat #9 is the button
Seat 1: Fedayn72 (3235 in chips) 
Seat 2: vikim08 (2925 in chips) 
Seat 3: frankyhh_hh (3065 in chips) 
Seat 4: playnene (3000 in chips) 
Seat 5: Kurre1 (3010 in chips) 
Seat 6: ribolov01 (3110 in chips) 
Seat 7: 1LATESHOW1 (3057 in chips) 
Seat 8: malik_msk (1503 in chips) 
Seat 9: 2NDclass (7095 in chips) 
Fedayn72: posts small blind 20
vikim08: posts big blind 40
*** HOLE CARDS ***
Dealt to malik_msk [3d Jd]
frankyhh_hh: folds 
playnene: folds 
Kurre1: calls 40
ribolov01: folds 
1LATESHOW1: raises 140 to 180
malik_msk: calls 180
2NDclass: folds 
Fedayn72: folds 
vikim08: folds 
Kurre1: calls 140
*** FLOP *** [6s 9c Td]
Kurre1: bets 80
1LATESHOW1: raises 200 to 280
malik_msk: calls 280
Kurre1: calls 200
*** TURN *** [6s 9c Td] [Kd]
Kurre1: checks 
1LATESHOW1: checks 
malik_msk: bets 1043 and is all-in
Kurre1: folds 
1LATESHOW1: folds 
Uncalled bet (1043) returned to malik_msk
malik_msk collected 1440 from pot
malik_msk: doesn't show hand 
*** SUMMARY ***
Total pot 1440 | Rake 0 
Board [6s 9c Td Kd]
Seat 1: Fedayn72 (small blind) folded before Flop
Seat 2: vikim08 (big blind) folded before Flop
Seat 3: frankyhh_hh folded before Flop (didn't bet)
Seat 4: playnene folded before Flop (didn't bet)
Seat 5: Kurre1 folded on the Turn
Seat 6: ribolov01 folded before Flop (didn't bet)
Seat 7: 1LATESHOW1 folded on the Turn
Seat 8: malik_msk collected (1440)
Seat 9: 2NDclass (button) folded before Flop (didn't bet)



PokerStars Game #69705140102: Tournament #544010396, $20+$2 USD Hold'em No Limit - Level III (20/40) - 2011/10/29 20:25:16 MSK [2011/10/29 12:25:16 ET]
Table '544010396 89' 9-max Seat #1 is the button
Seat 1: Fedayn72 (3215 in chips) 
Seat 2: vikim08 (2885 in chips) 
Seat 3: frankyhh_hh (3065 in chips) 
Seat 4: playnene (3000 in chips) 
Seat 5: Kurre1 (2550 in chips) 
Seat 6: ribolov01 (3110 in chips) 
Seat 7: 1LATESHOW1 (2597 in chips) 
Seat 8: malik_msk (2483 in chips) 
Seat 9: 2NDclass (7095 in chips) 
vikim08: posts small blind 20
frankyhh_hh: posts big blind 40
*** HOLE CARDS ***
Dealt to malik_msk [3s 6d]
playnene: folds 
Kurre1: folds 
ribolov01: folds 
1LATESHOW1: raises 120 to 160
malik_msk: folds 
2NDclass: folds 
Fedayn72: folds 
vikim08: folds 
frankyhh_hh: folds 
Uncalled bet (120) returned to 1LATESHOW1
1LATESHOW1 collected 100 from pot
*** SUMMARY ***
Total pot 100 | Rake 0 
Seat 1: Fedayn72 (button) folded before Flop (didn't bet)
Seat 2: vikim08 (small blind) folded before Flop
Seat 3: frankyhh_hh (big blind) folded before Flop
Seat 4: playnene folded before Flop (didn't bet)
Seat 5: Kurre1 folded before Flop (didn't bet)
Seat 6: ribolov01 folded before Flop (didn't bet)
Seat 7: 1LATESHOW1 collected (100)
Seat 8: malik_msk folded before Flop (didn't bet)
Seat 9: 2NDclass folded before Flop (didn't bet)



PokerStars Game #69705172636: Tournament #544010396, $20+$2 USD Hold'em No Limit - Level III (20/40) - 2011/10/29 20:25:55 MSK [2011/10/29 12:25:55 ET]
Table '544010396 89' 9-max Seat #2 is the button
Seat 1: Fedayn72 (3215 in chips) 
Seat 2: vikim08 (2865 in chips) 
Seat 3: frankyhh_hh (3025 in chips) 
Seat 5: Kurre1 (2550 in chips) 
Seat 6: ribolov01 (3110 in chips) 
Seat 7: 1LATESHOW1 (2657 in chips) 
Seat 8: malik_msk (2483 in chips) 
Seat 9: 2NDclass (7095 in chips) 
frankyhh_hh: posts small blind 20
Kurre1: posts big blind 40
*** HOLE CARDS ***
Dealt to malik_msk [3h Qh]
ribolov01: raises 60 to 100
1LATESHOW1: folds 
malik_msk: calls 100
2NDclass: calls 100
Lotta<3 is connected 
Fedayn72: calls 100
vikim08: raises 500 to 600
frankyhh_hh: folds 
Kurre1: folds 
ribolov01: calls 500
malik_msk: folds 
2NDclass: folds 
Fedayn72: folds 
*** FLOP *** [Jh Qs 9d]
ribolov01: checks 
vikim08: bets 999
ribolov01: calls 999
*** TURN *** [Jh Qs 9d] [Qc]
ribolov01: bets 1511 and is all-in
vikim08: calls 1266 and is all-in
Uncalled bet (245) returned to ribolov01
*** RIVER *** [Jh Qs 9d Qc] [6d]
*** SHOW DOWN ***
ribolov01: shows [Ks Jd] (two pair, Queens and Jacks)
vikim08: shows [Ah As] (two pair, Aces and Queens)
vikim08 collected 6090 from pot
*** SUMMARY ***
Total pot 6090 | Rake 0 
Board [Jh Qs 9d Qc 6d]
Seat 1: Fedayn72 folded before Flop
Seat 2: vikim08 (button) showed [Ah As] and won (6090) with two pair, Aces and Queens
Seat 3: frankyhh_hh (small blind) folded before Flop
Seat 5: Kurre1 (big blind) folded before Flop
Seat 6: ribolov01 showed [Ks Jd] and lost with two pair, Queens and Jacks
Seat 7: 1LATESHOW1 folded before Flop (didn't bet)
Seat 8: malik_msk folded before Flop
Seat 9: 2NDclass folded before Flop



PokerStars Game #69705250939: Tournament #544010396, $20+$2 USD Hold'em No Limit - Level III (20/40) - 2011/10/29 20:27:30 MSK [2011/10/29 12:27:30 ET]
Table '544010396 89' 9-max Seat #3 is the button
Seat 1: Fedayn72 (3115 in chips) 
Seat 2: vikim08 (6090 in chips) 
Seat 3: frankyhh_hh (3005 in chips) 
Seat 4: Lotta<3 (3000 in chips) out of hand (moved from another table into small blind)
Seat 5: Kurre1 (2510 in chips) 
Seat 7: 1LATESHOW1 (2657 in chips) 
Seat 8: malik_msk (2383 in chips) 
Seat 9: 2NDclass (6995 in chips) 
Kurre1: posts small blind 20
1LATESHOW1: posts big blind 40
*** HOLE CARDS ***
Dealt to malik_msk [Ks 8d]
malik_msk: calls 40
2NDclass: folds 
Fedayn72: folds 
vikim08: folds 
frankyhh_hh: folds 
Kurre1: calls 20
1LATESHOW1: checks 
*** FLOP *** [Td 6s 8s]
Mr.Skapone is connected 
Kurre1: bets 80
1LATESHOW1: calls 80
malik_msk: calls 80
*** TURN *** [Td 6s 8s] [Jc]
Kurre1: checks 
1LATESHOW1: checks 
malik_msk: checks 
*** RIVER *** [Td 6s 8s Jc] [7c]
Kurre1: checks 
1LATESHOW1: bets 216
malik_msk: folds 
Kurre1: folds 
Uncalled bet (216) returned to 1LATESHOW1
1LATESHOW1 collected 360 from pot
*** SUMMARY ***
Total pot 360 | Rake 0 
Board [Td 6s 8s Jc 7c]
Seat 1: Fedayn72 folded before Flop (didn't bet)
Seat 2: vikim08 folded before Flop (didn't bet)
Seat 3: frankyhh_hh (button) folded before Flop (didn't bet)
Seat 5: Kurre1 (small blind) folded on the River
Seat 7: 1LATESHOW1 (big blind) collected (360)
Seat 8: malik_msk folded on the River
Seat 9: 2NDclass folded before Flop (didn't bet)



PokerStars Game #69705306105: Tournament #544010396, $20+$2 USD Hold'em No Limit - Level III (20/40) - 2011/10/29 20:28:36 MSK [2011/10/29 12:28:36 ET]
Table '544010396 89' 9-max Seat #5 is the button
Seat 1: Fedayn72 (3115 in chips) 
Seat 2: vikim08 (6090 in chips) 
Seat 3: frankyhh_hh (3005 in chips) 
Seat 4: Lotta<3 (3000 in chips) 
Seat 5: Kurre1 (2390 in chips) 
Seat 6: Mr.Skapone (3000 in chips) out of hand (moved from another table into small blind)
Seat 7: 1LATESHOW1 (2897 in chips) 
Seat 8: malik_msk (2263 in chips) 
Seat 9: 2NDclass (6995 in chips) 
1LATESHOW1: posts small blind 20
malik_msk: posts big blind 40
*** HOLE CARDS ***
Dealt to malik_msk [Qs 7c]
2NDclass: folds 
Fedayn72: folds 
vikim08: raises 80 to 120
frankyhh_hh: folds 
Lotta<3: folds 
Kurre1: folds 
1LATESHOW1: folds 
malik_msk: calls 80
*** FLOP *** [Js 5h 2s]
malik_msk: checks 
vikim08: bets 200
malik_msk: folds 
Uncalled bet (200) returned to vikim08
vikim08 collected 260 from pot
*** SUMMARY ***
Total pot 260 | Rake 0 
Board [Js 5h 2s]
Seat 1: Fedayn72 folded before Flop (didn't bet)
Seat 2: vikim08 collected (260)
Seat 3: frankyhh_hh folded before Flop (didn't bet)
Seat 4: Lotta<3 folded before Flop (didn't bet)
Seat 5: Kurre1 (button) folded before Flop (didn't bet)
Seat 7: 1LATESHOW1 (small blind) folded before Flop
Seat 8: malik_msk (big blind) folded on the Flop
Seat 9: 2NDclass folded before Flop (didn't bet)



PokerStars Game #69705358620: Tournament #544010396, $20+$2 USD Hold'em No Limit - Level III (20/40) - 2011/10/29 20:29:39 MSK [2011/10/29 12:29:39 ET]
Table '544010396 89' 9-max Seat #7 is the button
Seat 1: Fedayn72 (3115 in chips) 
Seat 2: vikim08 (6230 in chips) 
Seat 3: frankyhh_hh (3005 in chips) 
Seat 4: Lotta<3 (3000 in chips) 
Seat 5: Kurre1 (2390 in chips) 
Seat 6: Mr.Skapone (3000 in chips) 
Seat 7: 1LATESHOW1 (2877 in chips) 
Seat 8: malik_msk (2143 in chips) 
Seat 9: 2NDclass (6995 in chips) 
malik_msk: posts small blind 20
2NDclass: posts big blind 40
*** HOLE CARDS ***
Dealt to malik_msk [7c Qc]
Fedayn72: folds 
vikim08: folds 
frankyhh_hh: folds 
Lotta<3: folds 
Kurre1: folds 
Mr.Skapone: folds 
1LATESHOW1: raises 60 to 100
malik_msk: calls 80
2NDclass: folds 
*** FLOP *** [Qs 7h Ks]
malik_msk: bets 120
1LATESHOW1: folds 
Uncalled bet (120) returned to malik_msk
malik_msk collected 240 from pot
malik_msk: doesn't show hand 
*** SUMMARY ***
Total pot 240 | Rake 0 
Board [Qs 7h Ks]
Seat 1: Fedayn72 folded before Flop (didn't bet)
Seat 2: vikim08 folded before Flop (didn't bet)
Seat 3: frankyhh_hh folded before Flop (didn't bet)
Seat 4: Lotta<3 folded before Flop (didn't bet)
Seat 5: Kurre1 folded before Flop (didn't bet)
Seat 6: Mr.Skapone folded before Flop (didn't bet)
Seat 7: 1LATESHOW1 (button) folded on the Flop
Seat 8: malik_msk (small blind) collected (240)
Seat 9: 2NDclass (big blind) folded before Flop



PokerStars Game #69705411014: Tournament #544010396, $20+$2 USD Hold'em No Limit - Level IV (25/50) - 2011/10/29 20:30:42 MSK [2011/10/29 12:30:42 ET]
Table '544010396 89' 9-max Seat #8 is the button
Seat 1: Fedayn72 (3115 in chips) 
Seat 2: vikim08 (6230 in chips) 
Seat 3: frankyhh_hh (3005 in chips) 
Seat 4: Lotta<3 (3000 in chips) 
Seat 5: Kurre1 (2390 in chips) 
Seat 6: Mr.Skapone (3000 in chips) 
Seat 7: 1LATESHOW1 (2777 in chips) 
Seat 8: malik_msk (2283 in chips) 
Seat 9: 2NDclass (6955 in chips) 
2NDclass: posts small blind 25
Fedayn72: posts big blind 50
*** HOLE CARDS ***
Dealt to malik_msk [Ks Kc]
vikim08 has timed out
vikim08: folds 
vikim08 is sitting out
frankyhh_hh: folds 
Lotta<3: folds 
Kurre1: folds 
vikim08 has returned
Mr.Skapone: folds 
1LATESHOW1: folds 
malik_msk: raises 50 to 100
2NDclass: folds 
Fedayn72: calls 50
*** FLOP *** [8h Js Kd]
Fedayn72: checks 
malik_msk: bets 150
Fedayn72: raises 300 to 450
malik_msk: calls 300
*** TURN *** [8h Js Kd] [5s]
Fedayn72: bets 656
malik_msk: raises 656 to 1312
Fedayn72: raises 1253 to 2565 and is all-in
malik_msk: calls 421 and is all-in
Uncalled bet (832) returned to Fedayn72
*** RIVER *** [8h Js Kd 5s] [Jc]
*** SHOW DOWN ***
Fedayn72: shows [8c 8s] (a full house, Eights full of Jacks)
malik_msk: shows [Ks Kc] (a full house, Kings full of Jacks)
malik_msk collected 4591 from pot
*** SUMMARY ***
Total pot 4591 | Rake 0 
Board [8h Js Kd 5s Jc]
Seat 1: Fedayn72 (big blind) showed [8c 8s] and lost with a full house, Eights full of Jacks
Seat 2: vikim08 folded before Flop (didn't bet)
Seat 3: frankyhh_hh folded before Flop (didn't bet)
Seat 4: Lotta<3 folded before Flop (didn't bet)
Seat 5: Kurre1 folded before Flop (didn't bet)
Seat 6: Mr.Skapone folded before Flop (didn't bet)
Seat 7: 1LATESHOW1 folded before Flop (didn't bet)
Seat 8: malik_msk (button) showed [Ks Kc] and won (4591) with a full house, Kings full of Jacks
Seat 9: 2NDclass (small blind) folded before Flop



PokerStars Game #69705479820: Tournament #544010396, $20+$2 USD Hold'em No Limit - Level IV (25/50) - 2011/10/29 20:32:03 MSK [2011/10/29 12:32:03 ET]
Table '544010396 89' 9-max Seat #9 is the button
Seat 1: Fedayn72 (832 in chips) 
Seat 2: vikim08 (6230 in chips) 
Seat 3: frankyhh_hh (3005 in chips) 
Seat 4: Lotta<3 (3000 in chips) 
Seat 5: Kurre1 (2390 in chips) 
Seat 6: Mr.Skapone (3000 in chips) 
Seat 7: 1LATESHOW1 (2777 in chips) 
Seat 8: malik_msk (4591 in chips) 
Seat 9: 2NDclass (6930 in chips) 
Fedayn72: posts small blind 25
vikim08: posts big blind 50
*** HOLE CARDS ***
Dealt to malik_msk [Qh 4s]
frankyhh_hh: folds 
Lotta<3: folds 
Kurre1: folds 
Mr.Skapone: folds 
1LATESHOW1: raises 50 to 100
malik_msk: folds 
2NDclass: folds 
Fedayn72: folds 
vikim08: folds 
Uncalled bet (50) returned to 1LATESHOW1
1LATESHOW1 collected 125 from pot
*** SUMMARY ***
Total pot 125 | Rake 0 
Seat 1: Fedayn72 (small blind) folded before Flop
Seat 2: vikim08 (big blind) folded before Flop
Seat 3: frankyhh_hh folded before Flop (didn't bet)
Seat 4: Lotta<3 folded before Flop (didn't bet)
Seat 5: Kurre1 folded before Flop (didn't bet)
Seat 6: Mr.Skapone folded before Flop (didn't bet)
Seat 7: 1LATESHOW1 collected (125)
Seat 8: malik_msk folded before Flop (didn't bet)
Seat 9: 2NDclass (button) folded before Flop (didn't bet)



PokerStars Game #69705517843: Tournament #544010396, $20+$2 USD Hold'em No Limit - Level IV (25/50) - 2011/10/29 20:32:47 MSK [2011/10/29 12:32:47 ET]
Table '544010396 89' 9-max Seat #1 is the button
Seat 1: Fedayn72 (807 in chips) 
Seat 2: vikim08 (6180 in chips) 
Seat 3: frankyhh_hh (3005 in chips) 
Seat 4: Lotta<3 (3000 in chips) 
Seat 5: Kurre1 (2390 in chips) 
Seat 6: Mr.Skapone (3000 in chips) 
Seat 7: 1LATESHOW1 (2852 in chips) 
Seat 8: malik_msk (4591 in chips) 
Seat 9: 2NDclass (6930 in chips) 
vikim08: posts small blind 25
frankyhh_hh: posts big blind 50
*** HOLE CARDS ***
Dealt to malik_msk [2c Td]
Lotta<3: folds 
Kurre1: calls 50
Mr.Skapone: calls 50
1LATESHOW1: folds 
malik_msk: calls 50
2NDclass: folds 
Fedayn72: folds 
vikim08: calls 25
frankyhh_hh: checks 
*** FLOP *** [Kd Ts Ah]
vikim08: checks 
frankyhh_hh: checks 
Kurre1: checks 
Mr.Skapone: checks 
malik_msk: bets 50
vikim08: raises 150 to 200
frankyhh_hh: folds 
Kurre1: folds 
Mr.Skapone: folds 
malik_msk: folds 
Uncalled bet (150) returned to vikim08
vikim08 collected 350 from pot
*** SUMMARY ***
Total pot 350 | Rake 0 
Board [Kd Ts Ah]
Seat 1: Fedayn72 (button) folded before Flop (didn't bet)
Seat 2: vikim08 (small blind) collected (350)
Seat 3: frankyhh_hh (big blind) folded on the Flop
Seat 4: Lotta<3 folded before Flop (didn't bet)
Seat 5: Kurre1 folded on the Flop
Seat 6: Mr.Skapone folded on the Flop
Seat 7: 1LATESHOW1 folded before Flop (didn't bet)
Seat 8: malik_msk folded on the Flop
Seat 9: 2NDclass folded before Flop (didn't bet)



PokerStars Game #69705571096: Tournament #544010396, $20+$2 USD Hold'em No Limit - Level IV (25/50) - 2011/10/29 20:33:50 MSK [2011/10/29 12:33:50 ET]
Table '544010396 89' 9-max Seat #2 is the button
Seat 1: Fedayn72 (807 in chips) 
Seat 2: vikim08 (6430 in chips) 
Seat 3: frankyhh_hh (2955 in chips) 
Seat 4: Lotta<3 (3000 in chips) 
Seat 5: Kurre1 (2340 in chips) 
Seat 6: Mr.Skapone (2950 in chips) 
Seat 7: 1LATESHOW1 (2852 in chips) 
Seat 8: malik_msk (4491 in chips) 
Seat 9: 2NDclass (6930 in chips) 
frankyhh_hh: posts small blind 25
Lotta<3: posts big blind 50
*** HOLE CARDS ***
Dealt to malik_msk [4h 6h]
Kurre1: folds 
Mr.Skapone: folds 
1LATESHOW1: folds 
malik_msk: calls 50
2NDclass: raises 150 to 200
Fedayn72: folds 
vikim08: folds 
frankyhh_hh: folds 
Lotta<3: folds 
malik_msk: calls 150
*** FLOP *** [Jh Ah 5s]
malik_msk: checks 
2NDclass: bets 218
malik_msk: calls 218
*** TURN *** [Jh Ah 5s] [Js]
malik_msk: checks 
2NDclass: checks 
*** RIVER *** [Jh Ah 5s Js] [Qc]
malik_msk: bets 650
2NDclass: folds 
Uncalled bet (650) returned to malik_msk
malik_msk collected 911 from pot
malik_msk: doesn't show hand 
*** SUMMARY ***
Total pot 911 | Rake 0 
Board [Jh Ah 5s Js Qc]
Seat 1: Fedayn72 folded before Flop (didn't bet)
Seat 2: vikim08 (button) folded before Flop (didn't bet)
Seat 3: frankyhh_hh (small blind) folded before Flop
Seat 4: Lotta<3 (big blind) folded before Flop
Seat 5: Kurre1 folded before Flop (didn't bet)
Seat 6: Mr.Skapone folded before Flop (didn't bet)
Seat 7: 1LATESHOW1 folded before Flop (didn't bet)
Seat 8: malik_msk collected (911)
Seat 9: 2NDclass folded on the River



PokerStars Game #69705634863: Tournament #544010396, $20+$2 USD Hold'em No Limit - Level IV (25/50) - 2011/10/29 20:35:05 MSK [2011/10/29 12:35:05 ET]
Table '544010396 89' 9-max Seat #3 is the button
Seat 1: Fedayn72 (807 in chips) 
Seat 2: vikim08 (6430 in chips) 
Seat 3: frankyhh_hh (2930 in chips) 
Seat 4: Lotta<3 (2950 in chips) 
Seat 5: Kurre1 (2340 in chips) 
Seat 6: Mr.Skapone (2950 in chips) 
Seat 7: 1LATESHOW1 (2852 in chips) 
Seat 8: malik_msk (4984 in chips) 
Seat 9: 2NDclass (6512 in chips) 
Lotta<3: posts small blind 25
Kurre1: posts big blind 50
*** HOLE CARDS ***
Dealt to malik_msk [5c Ac]
Mr.Skapone: folds 
1LATESHOW1: raises 50 to 100
malik_msk: calls 100
2NDclass: folds 
Fedayn72: folds 
vikim08: folds 
frankyhh_hh: folds 
Lotta<3: folds 
Kurre1: folds 
*** FLOP *** [Td Qc Kh]
1LATESHOW1: bets 165
malik_msk: calls 165
*** TURN *** [Td Qc Kh] [Tc]
1LATESHOW1: checks 
malik_msk: checks 
*** RIVER *** [Td Qc Kh Tc] [5s]
1LATESHOW1: checks 
malik_msk: bets 400
1LATESHOW1: folds 
Uncalled bet (400) returned to malik_msk
malik_msk collected 605 from pot
malik_msk: doesn't show hand 
*** SUMMARY ***
Total pot 605 | Rake 0 
Board [Td Qc Kh Tc 5s]
Seat 1: Fedayn72 folded before Flop (didn't bet)
Seat 2: vikim08 folded before Flop (didn't bet)
Seat 3: frankyhh_hh (button) folded before Flop (didn't bet)
Seat 4: Lotta<3 (small blind) folded before Flop
Seat 5: Kurre1 (big blind) folded before Flop
Seat 6: Mr.Skapone folded before Flop (didn't bet)
Seat 7: 1LATESHOW1 folded on the River
Seat 8: malik_msk collected (605)
Seat 9: 2NDclass folded before Flop (didn't bet)



PokerStars Game #69705678068: Tournament #544010396, $20+$2 USD Hold'em No Limit - Level IV (25/50) - 2011/10/29 20:35:56 MSK [2011/10/29 12:35:56 ET]
Table '544010396 89' 9-max Seat #4 is the button
Seat 1: Fedayn72 (807 in chips) 
Seat 2: vikim08 (6430 in chips) 
Seat 3: frankyhh_hh (2930 in chips) 
Seat 4: Lotta<3 (2925 in chips) 
Seat 5: Kurre1 (2290 in chips) 
Seat 6: Mr.Skapone (2950 in chips) 
Seat 7: 1LATESHOW1 (2587 in chips) 
Seat 8: malik_msk (5324 in chips) 
Seat 9: 2NDclass (6512 in chips) 
Kurre1: posts small blind 25
Mr.Skapone: posts big blind 50
*** HOLE CARDS ***
Dealt to malik_msk [5d Ah]
1LATESHOW1: folds 
malik_msk: calls 50
2NDclass: calls 50
Fedayn72: folds 
vikim08: folds 
frankyhh_hh: folds 
Lotta<3: folds 
Kurre1: calls 25
Mr.Skapone: raises 350 to 400
malik_msk: folds 
2NDclass: calls 350
Kurre1: calls 350
*** FLOP *** [9c Js Kd]
Kurre1: checks 
Mr.Skapone: bets 650
2NDclass: folds 
Kurre1: folds 
Uncalled bet (650) returned to Mr.Skapone
Mr.Skapone collected 1250 from pot
*** SUMMARY ***
Total pot 1250 | Rake 0 
Board [9c Js Kd]
Seat 1: Fedayn72 folded before Flop (didn't bet)
Seat 2: vikim08 folded before Flop (didn't bet)
Seat 3: frankyhh_hh folded before Flop (didn't bet)
Seat 4: Lotta<3 (button) folded before Flop (didn't bet)
Seat 5: Kurre1 (small blind) folded on the Flop
Seat 6: Mr.Skapone (big blind) collected (1250)
Seat 7: 1LATESHOW1 folded before Flop (didn't bet)
Seat 8: malik_msk folded before Flop
Seat 9: 2NDclass folded on the Flop



PokerStars Game #69705755268: Tournament #544010396, $20+$2 USD Hold'em No Limit - Level IV (25/50) - 2011/10/29 20:37:28 MSK [2011/10/29 12:37:28 ET]
Table '544010396 89' 9-max Seat #5 is the button
Seat 1: Fedayn72 (807 in chips) 
Seat 2: vikim08 (6430 in chips) 
Seat 3: frankyhh_hh (2930 in chips) 
Seat 4: Lotta<3 (2925 in chips) 
Seat 5: Kurre1 (1890 in chips) 
Seat 6: Mr.Skapone (3800 in chips) 
Seat 7: 1LATESHOW1 (2587 in chips) 
Seat 8: malik_msk (5274 in chips) 
Seat 9: 2NDclass (6112 in chips) 
Mr.Skapone: posts small blind 25
1LATESHOW1: posts big blind 50
*** HOLE CARDS ***
Dealt to malik_msk [3d 8d]
malik_msk: calls 50
2NDclass: calls 50
Fedayn72: raises 757 to 807 and is all-in
vikim08: folds 
frankyhh_hh: folds 
Lotta<3: folds 
Kurre1: folds 
Mr.Skapone: folds 
1LATESHOW1: folds 
malik_msk: folds 
2NDclass: calls 757
*** FLOP *** [Kh 8s As]
*** TURN *** [Kh 8s As] [4h]
*** RIVER *** [Kh 8s As 4h] [3h]
*** SHOW DOWN ***
2NDclass: shows [Jc 8c] (a pair of Eights)
Fedayn72: shows [Ah Qh] (a flush, Ace high)
Fedayn72 collected 1739 from pot
*** SUMMARY ***
Total pot 1739 | Rake 0 
Board [Kh 8s As 4h 3h]
Seat 1: Fedayn72 showed [Ah Qh] and won (1739) with a flush, Ace high
Seat 2: vikim08 folded before Flop (didn't bet)
Seat 3: frankyhh_hh folded before Flop (didn't bet)
Seat 4: Lotta<3 folded before Flop (didn't bet)
Seat 5: Kurre1 (button) folded before Flop (didn't bet)
Seat 6: Mr.Skapone (small blind) folded before Flop
Seat 7: 1LATESHOW1 (big blind) folded before Flop
Seat 8: malik_msk folded before Flop
Seat 9: 2NDclass showed [Jc 8c] and lost with a pair of Eights



PokerStars Game #69705791796: Tournament #544010396, $20+$2 USD Hold'em No Limit - Level IV (25/50) - 2011/10/29 20:38:12 MSK [2011/10/29 12:38:12 ET]
Table '544010396 89' 9-max Seat #6 is the button
Seat 1: Fedayn72 (1739 in chips) 
Seat 2: vikim08 (6430 in chips) 
Seat 3: frankyhh_hh (2930 in chips) 
Seat 4: Lotta<3 (2925 in chips) 
Seat 5: Kurre1 (1890 in chips) 
Seat 6: Mr.Skapone (3775 in chips) 
Seat 7: 1LATESHOW1 (2537 in chips) 
Seat 8: malik_msk (5224 in chips) 
Seat 9: 2NDclass (5305 in chips) 
1LATESHOW1: posts small blind 25
malik_msk: posts big blind 50
*** HOLE CARDS ***
Dealt to malik_msk [Ah Kc]
2NDclass: raises 64 to 114
Fedayn72: folds 
vikim08: folds 
frankyhh_hh: folds 
Lotta<3: folds 
Kurre1: calls 114
Mr.Skapone: folds 
1LATESHOW1: folds 
malik_msk: calls 64
*** FLOP *** [8d Ac 6h]
malik_msk: bets 300
2NDclass: calls 300
Kurre1: folds 
*** TURN *** [8d Ac 6h] [8c]
malik_msk: bets 500
2NDclass: calls 500
*** RIVER *** [8d Ac 6h 8c] [8s]
malik_msk: bets 1400
2NDclass: calls 1400
*** SHOW DOWN ***
malik_msk: shows [Ah Kc] (a full house, Eights full of Aces)
2NDclass: mucks hand 
malik_msk collected 4767 from pot
*** SUMMARY ***
Total pot 4767 | Rake 0 
Board [8d Ac 6h 8c 8s]
Seat 1: Fedayn72 folded before Flop (didn't bet)
Seat 2: vikim08 folded before Flop (didn't bet)
Seat 3: frankyhh_hh folded before Flop (didn't bet)
Seat 4: Lotta<3 folded before Flop (didn't bet)
Seat 5: Kurre1 folded on the Flop
Seat 6: Mr.Skapone (button) folded before Flop (didn't bet)
Seat 7: 1LATESHOW1 (small blind) folded before Flop
Seat 8: malik_msk (big blind) showed [Ah Kc] and won (4767) with a full house, Eights full of Aces
Seat 9: 2NDclass mucked [Td Tc]



PokerStars Game #69705829514: Tournament #544010396, $20+$2 USD Hold'em No Limit - Level IV (25/50) - 2011/10/29 20:38:58 MSK [2011/10/29 12:38:58 ET]
Table '544010396 89' 9-max Seat #7 is the button
Seat 1: Fedayn72 (1739 in chips) 
Seat 2: vikim08 (6430 in chips) 
Seat 3: frankyhh_hh (2930 in chips) 
Seat 4: Lotta<3 (2925 in chips) 
Seat 5: Kurre1 (1776 in chips) 
Seat 6: Mr.Skapone (3775 in chips) 
Seat 7: 1LATESHOW1 (2512 in chips) 
Seat 8: malik_msk (7677 in chips) 
Seat 9: 2NDclass (2991 in chips) 
malik_msk: posts small blind 25
2NDclass: posts big blind 50
*** HOLE CARDS ***
Dealt to malik_msk [2d Ad]
Fedayn72: folds 
vikim08: folds 
frankyhh_hh: folds 
Lotta<3: folds 
Kurre1: folds 
Mr.Skapone: folds 
1LATESHOW1: folds 
malik_msk: calls 25
2NDclass: raises 200 to 250
malik_msk: calls 200
*** FLOP *** [5s Ts 8s]
malik_msk: checks 
2NDclass: bets 230
malik_msk: folds 
Uncalled bet (230) returned to 2NDclass
2NDclass collected 500 from pot
2NDclass: doesn't show hand 
*** SUMMARY ***
Total pot 500 | Rake 0 
Board [5s Ts 8s]
Seat 1: Fedayn72 folded before Flop (didn't bet)
Seat 2: vikim08 folded before Flop (didn't bet)
Seat 3: frankyhh_hh folded before Flop (didn't bet)
Seat 4: Lotta<3 folded before Flop (didn't bet)
Seat 5: Kurre1 folded before Flop (didn't bet)
Seat 6: Mr.Skapone folded before Flop (didn't bet)
Seat 7: 1LATESHOW1 (button) folded before Flop (didn't bet)
Seat 8: malik_msk (small blind) folded on the Flop
Seat 9: 2NDclass (big blind) collected (500)



PokerStars Game #69705890609: Tournament #544010396, $20+$2 USD Hold'em No Limit - Level V (30/60) - 2011/10/29 20:40:13 MSK [2011/10/29 12:40:13 ET]
Table '544010396 89' 9-max Seat #8 is the button
Seat 1: Fedayn72 (1739 in chips) 
Seat 2: vikim08 (6430 in chips) 
Seat 3: frankyhh_hh (2930 in chips) 
Seat 4: Lotta<3 (2925 in chips) 
Seat 5: Kurre1 (1776 in chips) 
Seat 6: Mr.Skapone (3775 in chips) 
Seat 7: 1LATESHOW1 (2512 in chips) 
Seat 8: malik_msk (7427 in chips) 
Seat 9: 2NDclass (3241 in chips) 
Fedayn72: posts the ante 5
vikim08: posts the ante 5
frankyhh_hh: posts the ante 5
Lotta<3: posts the ante 5
Kurre1: posts the ante 5
Mr.Skapone: posts the ante 5
1LATESHOW1: posts the ante 5
malik_msk: posts the ante 5
2NDclass: posts the ante 5
2NDclass: posts small blind 30
Fedayn72: posts big blind 60
*** HOLE CARDS ***
Dealt to malik_msk [3d 6c]
vikim08: folds 
frankyhh_hh: folds 
Lotta<3: folds 
Kurre1: folds 
Mr.Skapone: folds 
1LATESHOW1: folds 
malik_msk: folds 
2NDclass: folds 
Uncalled bet (30) returned to Fedayn72
Fedayn72 collected 105 from pot
Fedayn72: doesn't show hand 
*** SUMMARY ***
Total pot 105 | Rake 0 
Seat 1: Fedayn72 (big blind) collected (105)
Seat 2: vikim08 folded before Flop (didn't bet)
Seat 3: frankyhh_hh folded before Flop (didn't bet)
Seat 4: Lotta<3 folded before Flop (didn't bet)
Seat 5: Kurre1 folded before Flop (didn't bet)
Seat 6: Mr.Skapone folded before Flop (didn't bet)
Seat 7: 1LATESHOW1 folded before Flop (didn't bet)
Seat 8: malik_msk (button) folded before Flop (didn't bet)
Seat 9: 2NDclass (small blind) folded before Flop



PokerStars Game #69705911493: Tournament #544010396, $20+$2 USD Hold'em No Limit - Level V (30/60) - 2011/10/29 20:40:38 MSK [2011/10/29 12:40:38 ET]
Table '544010396 89' 9-max Seat #9 is the button
Seat 1: Fedayn72 (1809 in chips) 
Seat 2: vikim08 (6425 in chips) 
Seat 3: frankyhh_hh (2925 in chips) 
Seat 4: Lotta<3 (2920 in chips) 
Seat 5: Kurre1 (1771 in chips) 
Seat 6: Mr.Skapone (3770 in chips) 
Seat 7: 1LATESHOW1 (2507 in chips) 
Seat 8: malik_msk (7422 in chips) 
Seat 9: 2NDclass (3206 in chips) 
Fedayn72: posts the ante 5
vikim08: posts the ante 5
frankyhh_hh: posts the ante 5
Lotta<3: posts the ante 5
Kurre1: posts the ante 5
Mr.Skapone: posts the ante 5
1LATESHOW1: posts the ante 5
malik_msk: posts the ante 5
2NDclass: posts the ante 5
Fedayn72: posts small blind 30
vikim08: posts big blind 60
*** HOLE CARDS ***
Dealt to malik_msk [6h 8s]
frankyhh_hh: folds 
Lotta<3: folds 
Kurre1: folds 
Mr.Skapone: folds 
1LATESHOW1: raises 90 to 150
malik_msk: folds 
Mr.Skapone is sitting out
2NDclass: folds 
Fedayn72: folds 
vikim08: folds 
Uncalled bet (90) returned to 1LATESHOW1
1LATESHOW1 collected 195 from pot
*** SUMMARY ***
Total pot 195 | Rake 0 
Seat 1: Fedayn72 (small blind) folded before Flop
Seat 2: vikim08 (big blind) folded before Flop
Seat 3: frankyhh_hh folded before Flop (didn't bet)
Seat 4: Lotta<3 folded before Flop (didn't bet)
Seat 5: Kurre1 folded before Flop (didn't bet)
Seat 6: Mr.Skapone folded before Flop (didn't bet)
Seat 7: 1LATESHOW1 collected (195)
Seat 8: malik_msk folded before Flop (didn't bet)
Seat 9: 2NDclass (button) folded before Flop (didn't bet)



PokerStars Game #69705939553: Tournament #544010396, $20+$2 USD Hold'em No Limit - Level V (30/60) - 2011/10/29 20:41:12 MSK [2011/10/29 12:41:12 ET]
Table '544010396 89' 9-max Seat #1 is the button
Seat 1: Fedayn72 (1774 in chips) 
Seat 2: vikim08 (6360 in chips) 
Seat 3: frankyhh_hh (2920 in chips) 
Seat 4: Lotta<3 (2915 in chips) 
Seat 5: Kurre1 (1766 in chips) 
Seat 6: Mr.Skapone (3765 in chips) is sitting out
Seat 7: 1LATESHOW1 (2637 in chips) 
Seat 8: malik_msk (7417 in chips) 
Seat 9: 2NDclass (3201 in chips) 
Fedayn72: posts the ante 5
vikim08: posts the ante 5
frankyhh_hh: posts the ante 5
Lotta<3: posts the ante 5
Kurre1: posts the ante 5
Mr.Skapone: posts the ante 5
1LATESHOW1: posts the ante 5
malik_msk: posts the ante 5
2NDclass: posts the ante 5
vikim08: posts small blind 30
frankyhh_hh: posts big blind 60
*** HOLE CARDS ***
Dealt to malik_msk [Js 2s]
Lotta<3: folds 
Kurre1: folds 
Mr.Skapone: folds 
1LATESHOW1: folds 
malik_msk: calls 60
2NDclass: raises 180 to 240
Fedayn72: folds 
vikim08: folds 
frankyhh_hh: folds 
malik_msk: calls 180
*** FLOP *** [3s 6c Kh]
malik_msk: checks 
2NDclass: bets 300
malik_msk: folds 
Uncalled bet (300) returned to 2NDclass
2NDclass collected 615 from pot
2NDclass: doesn't show hand 
*** SUMMARY ***
Total pot 615 | Rake 0 
Board [3s 6c Kh]
Seat 1: Fedayn72 (button) folded before Flop (didn't bet)
Seat 2: vikim08 (small blind) folded before Flop
Seat 3: frankyhh_hh (big blind) folded before Flop
Seat 4: Lotta<3 folded before Flop (didn't bet)
Seat 5: Kurre1 folded before Flop (didn't bet)
Seat 6: Mr.Skapone folded before Flop (didn't bet)
Seat 7: 1LATESHOW1 folded before Flop (didn't bet)
Seat 8: malik_msk folded on the Flop
Seat 9: 2NDclass collected (615)



PokerStars Game #69705968239: Tournament #544010396, $20+$2 USD Hold'em No Limit - Level V (30/60) - 2011/10/29 20:41:47 MSK [2011/10/29 12:41:47 ET]
Table '544010396 89' 9-max Seat #2 is the button
Seat 1: Fedayn72 (1769 in chips) 
Seat 2: vikim08 (6325 in chips) 
Seat 3: frankyhh_hh (2855 in chips) 
Seat 4: Lotta<3 (2910 in chips) 
Seat 5: Kurre1 (1761 in chips) 
Seat 6: Mr.Skapone (3760 in chips) is sitting out
Seat 7: 1LATESHOW1 (2632 in chips) 
Seat 8: malik_msk (7172 in chips) 
Seat 9: 2NDclass (3571 in chips) 
Fedayn72: posts the ante 5
vikim08: posts the ante 5
frankyhh_hh: posts the ante 5
Lotta<3: posts the ante 5
Kurre1: posts the ante 5
Mr.Skapone: posts the ante 5
1LATESHOW1: posts the ante 5
malik_msk: posts the ante 5
2NDclass: posts the ante 5
frankyhh_hh: posts small blind 30
Lotta<3: posts big blind 60
*** HOLE CARDS ***
Dealt to malik_msk [Qs Js]
Kurre1: calls 60
Mr.Skapone: folds 
Mr.Skapone has returned
1LATESHOW1: folds 
malik_msk: calls 60
2NDclass: folds 
Fedayn72: folds 
vikim08: folds 
frankyhh_hh: folds 
Lotta<3: checks 
*** FLOP *** [9c 7s 6h]
Lotta<3: checks 
Kurre1: checks 
malik_msk: checks 
*** TURN *** [9c 7s 6h] [7h]
Lotta<3: checks 
Kurre1: checks 
malik_msk: checks 
*** RIVER *** [9c 7s 6h 7h] [3d]
Lotta<3: checks 
Kurre1: checks 
malik_msk: checks 
*** SHOW DOWN ***
Lotta<3: shows [2h Kh] (a pair of Sevens)
Kurre1: shows [4c 4h] (two pair, Sevens and Fours)
malik_msk: mucks hand 
Kurre1 collected 255 from pot
*** SUMMARY ***
Total pot 255 | Rake 0 
Board [9c 7s 6h 7h 3d]
Seat 1: Fedayn72 folded before Flop (didn't bet)
Seat 2: vikim08 (button) folded before Flop (didn't bet)
Seat 3: frankyhh_hh (small blind) folded before Flop
Seat 4: Lotta<3 (big blind) showed [2h Kh] and lost with a pair of Sevens
Seat 5: Kurre1 showed [4c 4h] and won (255) with two pair, Sevens and Fours
Seat 6: Mr.Skapone folded before Flop (didn't bet)
Seat 7: 1LATESHOW1 folded before Flop (didn't bet)
Seat 8: malik_msk mucked [Qs Js]
Seat 9: 2NDclass folded before Flop (didn't bet)



PokerStars Game #69706009657: Tournament #544010396, $20+$2 USD Hold'em No Limit - Level V (30/60) - 2011/10/29 20:42:35 MSK [2011/10/29 12:42:35 ET]
Table '544010396 89' 9-max Seat #3 is the button
Seat 1: Fedayn72 (1764 in chips) 
Seat 2: vikim08 (6320 in chips) 
Seat 3: frankyhh_hh (2820 in chips) 
Seat 4: Lotta<3 (2845 in chips) 
Seat 5: Kurre1 (1951 in chips) 
Seat 6: Mr.Skapone (3755 in chips) 
Seat 7: 1LATESHOW1 (2627 in chips) 
Seat 8: malik_msk (7107 in chips) 
Seat 9: 2NDclass (3566 in chips) 
Fedayn72: posts the ante 5
vikim08: posts the ante 5
frankyhh_hh: posts the ante 5
Lotta<3: posts the ante 5
Kurre1: posts the ante 5
Mr.Skapone: posts the ante 5
1LATESHOW1: posts the ante 5
malik_msk: posts the ante 5
2NDclass: posts the ante 5
Lotta<3: posts small blind 30
Kurre1: posts big blind 60
*** HOLE CARDS ***
Dealt to malik_msk [8s 5h]
Mr.Skapone: folds 
1LATESHOW1: raises 60 to 120
malik_msk: folds 
2NDclass: folds 
Fedayn72: folds 
vikim08: folds 
frankyhh_hh: folds 
Lotta<3: folds 
Kurre1: folds 
Uncalled bet (60) returned to 1LATESHOW1
1LATESHOW1 collected 195 from pot
*** SUMMARY ***
Total pot 195 | Rake 0 
Seat 1: Fedayn72 folded before Flop (didn't bet)
Seat 2: vikim08 folded before Flop (didn't bet)
Seat 3: frankyhh_hh (button) folded before Flop (didn't bet)
Seat 4: Lotta<3 (small blind) folded before Flop
Seat 5: Kurre1 (big blind) folded before Flop
Seat 6: Mr.Skapone folded before Flop (didn't bet)
Seat 7: 1LATESHOW1 collected (195)
Seat 8: malik_msk folded before Flop (didn't bet)
Seat 9: 2NDclass folded before Flop (didn't bet)



PokerStars Game #69706039398: Tournament #544010396, $20+$2 USD Hold'em No Limit - Level V (30/60) - 2011/10/29 20:43:11 MSK [2011/10/29 12:43:11 ET]
Table '544010396 89' 9-max Seat #4 is the button
Seat 1: Fedayn72 (1759 in chips) 
Seat 2: vikim08 (6315 in chips) 
Seat 3: frankyhh_hh (2815 in chips) 
Seat 4: Lotta<3 (2810 in chips) 
Seat 5: Kurre1 (1886 in chips) 
Seat 6: Mr.Skapone (3750 in chips) 
Seat 7: 1LATESHOW1 (2757 in chips) 
Seat 8: malik_msk (7102 in chips) 
Seat 9: 2NDclass (3561 in chips) 
Fedayn72: posts the ante 5
vikim08: posts the ante 5
frankyhh_hh: posts the ante 5
Lotta<3: posts the ante 5
Kurre1: posts the ante 5
Mr.Skapone: posts the ante 5
1LATESHOW1: posts the ante 5
malik_msk: posts the ante 5
2NDclass: posts the ante 5
Kurre1: posts small blind 30
Mr.Skapone: posts big blind 60
*** HOLE CARDS ***
Dealt to malik_msk [9c 8h]
1LATESHOW1: raises 60 to 120
malik_msk: calls 120
2NDclass: folds 
Fedayn72: folds 
vikim08: raises 360 to 480
frankyhh_hh: folds 
Lotta<3: folds 
Kurre1: folds 
Mr.Skapone: folds 
1LATESHOW1: calls 360
malik_msk: calls 360
*** FLOP *** [5h Kd Ad]
1LATESHOW1: checks 
malik_msk: checks 
vikim08: checks 
*** TURN *** [5h Kd Ad] [Ks]
1LATESHOW1: checks 
malik_msk: checks 
vikim08: checks 
*** RIVER *** [5h Kd Ad Ks] [7s]
1LATESHOW1: checks 
malik_msk: checks 
vikim08: checks 
*** SHOW DOWN ***
1LATESHOW1: shows [Tc Jc] (a pair of Kings)
malik_msk: mucks hand 
vikim08: shows [Qs Qh] (two pair, Kings and Queens)
vikim08 collected 1575 from pot
*** SUMMARY ***
Total pot 1575 | Rake 0 
Board [5h Kd Ad Ks 7s]
Seat 1: Fedayn72 folded before Flop (didn't bet)
Seat 2: vikim08 showed [Qs Qh] and won (1575) with two pair, Kings and Queens
Seat 3: frankyhh_hh folded before Flop (didn't bet)
Seat 4: Lotta<3 (button) folded before Flop (didn't bet)
Seat 5: Kurre1 (small blind) folded before Flop
Seat 6: Mr.Skapone (big blind) folded before Flop
Seat 7: 1LATESHOW1 showed [Tc Jc] and lost with a pair of Kings
Seat 8: malik_msk mucked [9c 8h]
Seat 9: 2NDclass folded before Flop (didn't bet)



PokerStars Game #69706161581: Tournament #544010396, $20+$2 USD Hold'em No Limit - Level V (30/60) - 2011/10/29 20:45:33 MSK [2011/10/29 12:45:33 ET]
Table '544010396 89' 9-max Seat #5 is the button
Seat 1: Fedayn72 (1754 in chips) 
Seat 2: vikim08 (7405 in chips) 
Seat 3: frankyhh_hh (2810 in chips) 
Seat 4: Lotta<3 (2805 in chips) 
Seat 5: Kurre1 (1851 in chips) 
Seat 6: Mr.Skapone (3685 in chips) 
Seat 7: 1LATESHOW1 (2272 in chips) 
Seat 8: malik_msk (6617 in chips) 
Seat 9: 2NDclass (3556 in chips) 
Fedayn72: posts the ante 5
vikim08: posts the ante 5
frankyhh_hh: posts the ante 5
Lotta<3: posts the ante 5
Kurre1: posts the ante 5
Mr.Skapone: posts the ante 5
1LATESHOW1: posts the ante 5
malik_msk: posts the ante 5
2NDclass: posts the ante 5
Mr.Skapone: posts small blind 30
1LATESHOW1: posts big blind 60
*** HOLE CARDS ***
Dealt to malik_msk [Qh 4c]
malik_msk: folds 
2NDclass: folds 
Fedayn72: folds 
vikim08: folds 
frankyhh_hh: folds 
Lotta<3: folds 
Kurre1: calls 60
Mr.Skapone: calls 30
1LATESHOW1: raises 180 to 240
Kurre1: folds 
Mr.Skapone: calls 180
*** FLOP *** [4d Th 6c]
Mr.Skapone: checks 
1LATESHOW1: bets 351
Mr.Skapone: folds 
Uncalled bet (351) returned to 1LATESHOW1
1LATESHOW1 collected 585 from pot
*** SUMMARY ***
Total pot 585 | Rake 0 
Board [4d Th 6c]
Seat 1: Fedayn72 folded before Flop (didn't bet)
Seat 2: vikim08 folded before Flop (didn't bet)
Seat 3: frankyhh_hh folded before Flop (didn't bet)
Seat 4: Lotta<3 folded before Flop (didn't bet)
Seat 5: Kurre1 (button) folded before Flop
Seat 6: Mr.Skapone (small blind) folded on the Flop
Seat 7: 1LATESHOW1 (big blind) collected (585)
Seat 8: malik_msk folded before Flop (didn't bet)
Seat 9: 2NDclass folded before Flop (didn't bet)



PokerStars Game #69706222843: Tournament #544010396, $20+$2 USD Hold'em No Limit - Level V (30/60) - 2011/10/29 20:46:46 MSK [2011/10/29 12:46:46 ET]
Table '544010396 89' 9-max Seat #6 is the button
Seat 1: Fedayn72 (1749 in chips) 
Seat 2: vikim08 (7400 in chips) 
Seat 3: frankyhh_hh (2805 in chips) 
Seat 4: Lotta<3 (2800 in chips) 
Seat 5: Kurre1 (1786 in chips) 
Seat 6: Mr.Skapone (3440 in chips) 
Seat 7: 1LATESHOW1 (2612 in chips) 
Seat 8: malik_msk (6612 in chips) 
Seat 9: 2NDclass (3551 in chips) 
Fedayn72: posts the ante 5
vikim08: posts the ante 5
frankyhh_hh: posts the ante 5
Lotta<3: posts the ante 5
Kurre1: posts the ante 5
Mr.Skapone: posts the ante 5
1LATESHOW1: posts the ante 5
malik_msk: posts the ante 5
2NDclass: posts the ante 5
1LATESHOW1: posts small blind 30
malik_msk: posts big blind 60
*** HOLE CARDS ***
Dealt to malik_msk [3c 6c]
2NDclass: folds 
Fedayn72: folds 
vikim08: folds 
frankyhh_hh: folds 
Lotta<3: raises 120 to 180
Kurre1: calls 180
Mr.Skapone: folds 
1LATESHOW1: folds 
malik_msk: calls 120
*** FLOP *** [Kd 9s Qd]
malik_msk: checks 
Lotta<3: bets 240
Kurre1: calls 240
malik_msk: folds 
*** TURN *** [Kd 9s Qd] [6d]
Lotta<3: checks 
Kurre1: bets 240
Lotta<3: calls 240
*** RIVER *** [Kd 9s Qd 6d] [7h]
Lotta<3: checks 
Kurre1: checks 
*** SHOW DOWN ***
Lotta<3: shows [Ah Ks] (a pair of Kings)
Kurre1: shows [As Kc] (a pair of Kings)
Lotta<3 collected 788 from pot
Kurre1 collected 787 from pot
*** SUMMARY ***
Total pot 1575 | Rake 0 
Board [Kd 9s Qd 6d 7h]
Seat 1: Fedayn72 folded before Flop (didn't bet)
Seat 2: vikim08 folded before Flop (didn't bet)
Seat 3: frankyhh_hh folded before Flop (didn't bet)
Seat 4: Lotta<3 showed [Ah Ks] and won (788) with a pair of Kings
Seat 5: Kurre1 showed [As Kc] and won (787) with a pair of Kings
Seat 6: Mr.Skapone (button) folded before Flop (didn't bet)
Seat 7: 1LATESHOW1 (small blind) folded before Flop
Seat 8: malik_msk (big blind) folded on the Flop
Seat 9: 2NDclass folded before Flop (didn't bet)



PokerStars Game #69706289357: Tournament #544010396, $20+$2 USD Hold'em No Limit - Level V (30/60) - 2011/10/29 20:48:04 MSK [2011/10/29 12:48:04 ET]
Table '544010396 89' 9-max Seat #7 is the button
Seat 1: Fedayn72 (1744 in chips) 
Seat 2: vikim08 (7395 in chips) 
Seat 3: frankyhh_hh (2800 in chips) 
Seat 4: Lotta<3 (2923 in chips) 
Seat 5: Kurre1 (1908 in chips) 
Seat 6: Mr.Skapone (3435 in chips) 
Seat 7: 1LATESHOW1 (2577 in chips) 
Seat 8: malik_msk (6427 in chips) 
Seat 9: 2NDclass (3546 in chips) 
Fedayn72: posts the ante 5
vikim08: posts the ante 5
frankyhh_hh: posts the ante 5
Lotta<3: posts the ante 5
Kurre1: posts the ante 5
Mr.Skapone: posts the ante 5
1LATESHOW1: posts the ante 5
malik_msk: posts the ante 5
2NDclass: posts the ante 5
malik_msk: posts small blind 30
2NDclass: posts big blind 60
*** HOLE CARDS ***
Dealt to malik_msk [Ac Tc]
Fedayn72: folds 
vikim08: folds 
frankyhh_hh: folds 
Lotta<3: raises 120 to 180
Kurre1: calls 180
Mr.Skapone: folds 
1LATESHOW1: folds 
malik_msk: calls 150
2NDclass: calls 120
*** FLOP *** [8d 7c Qd]
malik_msk: checks 
2NDclass: checks 
Lotta<3: checks 
Kurre1: checks 
*** TURN *** [8d 7c Qd] [Ks]
malik_msk: checks 
2NDclass: checks 
Lotta<3: checks 
Kurre1: checks 
*** RIVER *** [8d 7c Qd Ks] [Kd]
malik_msk: checks 
2NDclass: checks 
Lotta<3: checks 
Kurre1: checks 
*** SHOW DOWN ***
malik_msk: shows [Ac Tc] (a pair of Kings)
2NDclass: shows [9s 9d] (two pair, Kings and Nines)
Lotta<3: shows [Jc Js] (two pair, Kings and Jacks)
Kurre1: mucks hand 
Lotta<3 collected 765 from pot
*** SUMMARY ***
Total pot 765 | Rake 0 
Board [8d 7c Qd Ks Kd]
Seat 1: Fedayn72 folded before Flop (didn't bet)
Seat 2: vikim08 folded before Flop (didn't bet)
Seat 3: frankyhh_hh folded before Flop (didn't bet)
Seat 4: Lotta<3 showed [Jc Js] and won (765) with two pair, Kings and Jacks
Seat 5: Kurre1 mucked [Td Ah]
Seat 6: Mr.Skapone folded before Flop (didn't bet)
Seat 7: 1LATESHOW1 (button) folded before Flop (didn't bet)
Seat 8: malik_msk (small blind) showed [Ac Tc] and lost with a pair of Kings
Seat 9: 2NDclass (big blind) showed [9s 9d] and lost with two pair, Kings and Nines



PokerStars Game #69706355292: Tournament #544010396, $20+$2 USD Hold'em No Limit - Level V (30/60) - 2011/10/29 20:49:23 MSK [2011/10/29 12:49:23 ET]
Table '544010396 89' 9-max Seat #8 is the button
Seat 1: Fedayn72 (1739 in chips) 
Seat 2: vikim08 (7390 in chips) 
Seat 3: frankyhh_hh (2795 in chips) 
Seat 4: Lotta<3 (3503 in chips) 
Seat 5: Kurre1 (1723 in chips) 
Seat 6: Mr.Skapone (3430 in chips) 
Seat 7: 1LATESHOW1 (2572 in chips) 
Seat 8: malik_msk (6242 in chips) 
Seat 9: 2NDclass (3361 in chips) 
Fedayn72: posts the ante 5
vikim08: posts the ante 5
frankyhh_hh: posts the ante 5
Lotta<3: posts the ante 5
Kurre1: posts the ante 5
Mr.Skapone: posts the ante 5
1LATESHOW1: posts the ante 5
malik_msk: posts the ante 5
2NDclass: posts the ante 5
2NDclass: posts small blind 30
Fedayn72: posts big blind 60
*** HOLE CARDS ***
Dealt to malik_msk [Qd 9h]
vikim08: raises 60 to 120
frankyhh_hh: folds 
Lotta<3: folds 
Kurre1: raises 480 to 600
Mr.Skapone: folds 
1LATESHOW1: folds 
malik_msk: folds 
2NDclass: folds 
Fedayn72: folds 
vikim08: folds [Ah]
Uncalled bet (480) returned to Kurre1
Kurre1 collected 375 from pot
*** SUMMARY ***
Total pot 375 | Rake 0 
Seat 1: Fedayn72 (big blind) folded before Flop
Seat 2: vikim08 folded before Flop
Seat 3: frankyhh_hh folded before Flop (didn't bet)
Seat 4: Lotta<3 folded before Flop (didn't bet)
Seat 5: Kurre1 collected (375)
Seat 6: Mr.Skapone folded before Flop (didn't bet)
Seat 7: 1LATESHOW1 folded before Flop (didn't bet)
Seat 8: malik_msk (button) folded before Flop (didn't bet)
Seat 9: 2NDclass (small blind) folded before Flop



PokerStars Game #69706414544: Tournament #544010396, $20+$2 USD Hold'em No Limit - Level VI (40/80) - 2011/10/29 20:50:33 MSK [2011/10/29 12:50:33 ET]
Table '544010396 89' 9-max Seat #9 is the button
Seat 1: Fedayn72 (1674 in chips) 
Seat 2: vikim08 (7265 in chips) 
Seat 3: frankyhh_hh (2790 in chips) 
Seat 4: Lotta<3 (3498 in chips) 
Seat 5: Kurre1 (1973 in chips) 
Seat 6: Mr.Skapone (3425 in chips) 
Seat 7: 1LATESHOW1 (2567 in chips) 
Seat 8: malik_msk (6237 in chips) 
Seat 9: 2NDclass (3326 in chips) 
Fedayn72: posts the ante 10
vikim08: posts the ante 10
frankyhh_hh: posts the ante 10
Lotta<3: posts the ante 10
Kurre1: posts the ante 10
Mr.Skapone: posts the ante 10
1LATESHOW1: posts the ante 10
malik_msk: posts the ante 10
2NDclass: posts the ante 10
Fedayn72: posts small blind 40
vikim08: posts big blind 80
*** HOLE CARDS ***
Dealt to malik_msk [Ac 3c]
frankyhh_hh: folds 
Lotta<3: folds 
Kurre1: folds 
Mr.Skapone: folds 
1LATESHOW1: folds 
malik_msk: raises 80 to 160
2NDclass: folds 
Fedayn72: folds 
vikim08: folds 
Uncalled bet (80) returned to malik_msk
malik_msk collected 290 from pot
malik_msk: doesn't show hand 
*** SUMMARY ***
Total pot 290 | Rake 0 
Seat 1: Fedayn72 (small blind) folded before Flop
Seat 2: vikim08 (big blind) folded before Flop
Seat 3: frankyhh_hh folded before Flop (didn't bet)
Seat 4: Lotta<3 folded before Flop (didn't bet)
Seat 5: Kurre1 folded before Flop (didn't bet)
Seat 6: Mr.Skapone folded before Flop (didn't bet)
Seat 7: 1LATESHOW1 folded before Flop (didn't bet)
Seat 8: malik_msk collected (290)
Seat 9: 2NDclass (button) folded before Flop (didn't bet)



PokerStars Game #69706473544: Tournament #544010396, $20+$2 USD Hold'em No Limit - Level VI (40/80) - 2011/10/29 20:51:43 MSK [2011/10/29 12:51:43 ET]
Table '544010396 89' 9-max Seat #1 is the button
Seat 1: Fedayn72 (1624 in chips) 
Seat 2: vikim08 (7175 in chips) 
Seat 3: frankyhh_hh (2780 in chips) 
Seat 4: Lotta<3 (3488 in chips) 
Seat 5: Kurre1 (1963 in chips) 
Seat 6: Mr.Skapone (3415 in chips) 
Seat 7: 1LATESHOW1 (2557 in chips) 
Seat 8: malik_msk (6437 in chips) 
Seat 9: 2NDclass (3316 in chips) 
Fedayn72: posts the ante 10
vikim08: posts the ante 10
frankyhh_hh: posts the ante 10
Lotta<3: posts the ante 10
Kurre1: posts the ante 10
Mr.Skapone: posts the ante 10
1LATESHOW1: posts the ante 10
malik_msk: posts the ante 10
2NDclass: posts the ante 10
vikim08: posts small blind 40
frankyhh_hh: posts big blind 80
*** HOLE CARDS ***
Dealt to malik_msk [4h 5h]
Lotta<3: folds 
Kurre1: folds 
Mr.Skapone: raises 141 to 221
1LATESHOW1: folds 
malik_msk: folds 
2NDclass: folds 
Fedayn72: folds 
vikim08: folds 
frankyhh_hh: folds 
Uncalled bet (141) returned to Mr.Skapone
Mr.Skapone collected 290 from pot
*** SUMMARY ***
Total pot 290 | Rake 0 
Seat 1: Fedayn72 (button) folded before Flop (didn't bet)
Seat 2: vikim08 (small blind) folded before Flop
Seat 3: frankyhh_hh (big blind) folded before Flop
Seat 4: Lotta<3 folded before Flop (didn't bet)
Seat 5: Kurre1 folded before Flop (didn't bet)
Seat 6: Mr.Skapone collected (290)
Seat 7: 1LATESHOW1 folded before Flop (didn't bet)
Seat 8: malik_msk folded before Flop (didn't bet)
Seat 9: 2NDclass folded before Flop (didn't bet)



PokerStars Game #69706538702: Tournament #544010396, $20+$2 USD Hold'em No Limit - Level VI (40/80) - 2011/10/29 20:53:00 MSK [2011/10/29 12:53:00 ET]
Table '544010396 89' 9-max Seat #2 is the button
Seat 1: Fedayn72 (1614 in chips) 
Seat 2: vikim08 (7125 in chips) 
Seat 3: frankyhh_hh (2690 in chips) 
Seat 4: Lotta<3 (3478 in chips) 
Seat 5: Kurre1 (1953 in chips) 
Seat 6: Mr.Skapone (3615 in chips) 
Seat 7: 1LATESHOW1 (2547 in chips) 
Seat 8: malik_msk (6427 in chips) 
Seat 9: 2NDclass (3306 in chips) 
Fedayn72: posts the ante 10
vikim08: posts the ante 10
frankyhh_hh: posts the ante 10
Lotta<3: posts the ante 10
Kurre1: posts the ante 10
Mr.Skapone: posts the ante 10
1LATESHOW1: posts the ante 10
malik_msk: posts the ante 10
2NDclass: posts the ante 10
frankyhh_hh: posts small blind 40
Lotta<3: posts big blind 80
*** HOLE CARDS ***
Dealt to malik_msk [Td Ad]
Kurre1: folds 
Mr.Skapone: folds 
1LATESHOW1: folds 
malik_msk: raises 80 to 160
2NDclass: folds 
Fedayn72: folds 
vikim08: folds 
frankyhh_hh: folds 
Lotta<3: folds 
Uncalled bet (80) returned to malik_msk
malik_msk collected 290 from pot
malik_msk: doesn't show hand 
*** SUMMARY ***
Total pot 290 | Rake 0 
Seat 1: Fedayn72 folded before Flop (didn't bet)
Seat 2: vikim08 (button) folded before Flop (didn't bet)
Seat 3: frankyhh_hh (small blind) folded before Flop
Seat 4: Lotta<3 (big blind) folded before Flop
Seat 5: Kurre1 folded before Flop (didn't bet)
Seat 6: Mr.Skapone folded before Flop (didn't bet)
Seat 7: 1LATESHOW1 folded before Flop (didn't bet)
Seat 8: malik_msk collected (290)
Seat 9: 2NDclass folded before Flop (didn't bet)



PokerStars Game #69706560675: Tournament #544010396, $20+$2 USD Hold'em No Limit - Level VI (40/80) - 2011/10/29 20:53:26 MSK [2011/10/29 12:53:26 ET]
Table '544010396 89' 9-max Seat #3 is the button
Seat 1: Fedayn72 (1604 in chips) 
Seat 2: vikim08 (7115 in chips) 
Seat 3: frankyhh_hh (2640 in chips) 
Seat 4: Lotta<3 (3388 in chips) 
Seat 5: Kurre1 (1943 in chips) 
Seat 6: Mr.Skapone (3605 in chips) 
Seat 7: 1LATESHOW1 (2537 in chips) 
Seat 8: malik_msk (6627 in chips) 
Seat 9: 2NDclass (3296 in chips) 
Fedayn72: posts the ante 10
vikim08: posts the ante 10
frankyhh_hh: posts the ante 10
Lotta<3: posts the ante 10
Kurre1: posts the ante 10
Mr.Skapone: posts the ante 10
1LATESHOW1: posts the ante 10
malik_msk: posts the ante 10
2NDclass: posts the ante 10
Lotta<3: posts small blind 40
Kurre1: posts big blind 80
*** HOLE CARDS ***
Dealt to malik_msk [3c Kd]
Mr.Skapone: folds 
1LATESHOW1: folds 
malik_msk: folds 
2NDclass: folds 
Fedayn72: raises 119 to 199
vikim08: calls 199
frankyhh_hh: calls 199
Lotta<3: folds 
Kurre1: folds 
*** FLOP *** [6d 8c 8d]
Fedayn72: checks 
vikim08: checks 
frankyhh_hh: bets 807
Fedayn72: folds 
vikim08: folds 
Uncalled bet (807) returned to frankyhh_hh
frankyhh_hh collected 807 from pot
*** SUMMARY ***
Total pot 807 | Rake 0 
Board [6d 8c 8d]
Seat 1: Fedayn72 folded on the Flop
Seat 2: vikim08 folded on the Flop
Seat 3: frankyhh_hh (button) collected (807)
Seat 4: Lotta<3 (small blind) folded before Flop
Seat 5: Kurre1 (big blind) folded before Flop
Seat 6: Mr.Skapone folded before Flop (didn't bet)
Seat 7: 1LATESHOW1 folded before Flop (didn't bet)
Seat 8: malik_msk folded before Flop (didn't bet)
Seat 9: 2NDclass folded before Flop (didn't bet)



PokerStars Game #69706613630: Tournament #544010396, $20+$2 USD Hold'em No Limit - Level VI (40/80) - 2011/10/29 20:54:30 MSK [2011/10/29 12:54:30 ET]
Table '544010396 89' 9-max Seat #4 is the button
Seat 1: Fedayn72 (1395 in chips) 
Seat 2: vikim08 (6906 in chips) 
Seat 3: frankyhh_hh (3238 in chips) 
Seat 4: Lotta<3 (3338 in chips) 
Seat 5: Kurre1 (1853 in chips) 
Seat 6: Mr.Skapone (3595 in chips) 
Seat 7: 1LATESHOW1 (2527 in chips) 
Seat 8: malik_msk (6617 in chips) 
Seat 9: 2NDclass (3286 in chips) 
Fedayn72: posts the ante 10
vikim08: posts the ante 10
frankyhh_hh: posts the ante 10
Lotta<3: posts the ante 10
Kurre1: posts the ante 10
Mr.Skapone: posts the ante 10
1LATESHOW1: posts the ante 10
malik_msk: posts the ante 10
2NDclass: posts the ante 10
Kurre1: posts small blind 40
Mr.Skapone: posts big blind 80
*** HOLE CARDS ***
Dealt to malik_msk [Qc 3s]
1LATESHOW1: folds 
malik_msk: folds 
2NDclass: folds 
Fedayn72: folds 
vikim08: folds 
frankyhh_hh: folds 
Lotta<3: folds 
Kurre1: folds 
Uncalled bet (40) returned to Mr.Skapone
Mr.Skapone collected 170 from pot
*** SUMMARY ***
Total pot 170 | Rake 0 
Seat 1: Fedayn72 folded before Flop (didn't bet)
Seat 2: vikim08 folded before Flop (didn't bet)
Seat 3: frankyhh_hh folded before Flop (didn't bet)
Seat 4: Lotta<3 (button) folded before Flop (didn't bet)
Seat 5: Kurre1 (small blind) folded before Flop
Seat 6: Mr.Skapone (big blind) collected (170)
Seat 7: 1LATESHOW1 folded before Flop (didn't bet)
Seat 8: malik_msk folded before Flop (didn't bet)
Seat 9: 2NDclass folded before Flop (didn't bet)



PokerStars Game #69706644495: Tournament #544010396, $20+$2 USD Hold'em No Limit - Level VI (40/80) - 2011/10/29 20:55:07 MSK [2011/10/29 12:55:07 ET]
Table '544010396 89' 9-max Seat #5 is the button
Seat 1: Fedayn72 (1385 in chips) 
Seat 2: vikim08 (6896 in chips) 
Seat 3: frankyhh_hh (3228 in chips) 
Seat 4: Lotta<3 (3328 in chips) 
Seat 5: Kurre1 (1803 in chips) 
Seat 6: Mr.Skapone (3715 in chips) 
Seat 7: 1LATESHOW1 (2517 in chips) 
Seat 8: malik_msk (6607 in chips) 
Seat 9: 2NDclass (3276 in chips) 
Fedayn72: posts the ante 10
vikim08: posts the ante 10
frankyhh_hh: posts the ante 10
Lotta<3: posts the ante 10
Kurre1: posts the ante 10
Mr.Skapone: posts the ante 10
1LATESHOW1: posts the ante 10
malik_msk: posts the ante 10
2NDclass: posts the ante 10
Mr.Skapone: posts small blind 40
1LATESHOW1: posts big blind 80
*** HOLE CARDS ***
Dealt to malik_msk [Kh 7h]
malik_msk: calls 80
2NDclass: folds 
Fedayn72: folds 
vikim08: folds 
frankyhh_hh: calls 80
Lotta<3: folds 
Kurre1: calls 80
Mr.Skapone: calls 40
1LATESHOW1: checks 
*** FLOP *** [6s 9s 5h]
Mr.Skapone: checks 
1LATESHOW1: bets 160
Lotta<3 is sitting out
malik_msk: calls 160
frankyhh_hh: calls 160
Kurre1: calls 160
Mr.Skapone: folds 
*** TURN *** [6s 9s 5h] [3c]
1LATESHOW1: bets 678
Lotta<3 is connected 
malik_msk: calls 678
Lotta<3 has returned
frankyhh_hh: calls 678
Kurre1: folds 
*** RIVER *** [6s 9s 5h 3c] [7d]
1LATESHOW1: bets 1589 and is all-in
malik_msk: folds 
frankyhh_hh: calls 1589
*** SHOW DOWN ***
1LATESHOW1: shows [8s 5d] (a straight, Five to Nine)
frankyhh_hh: shows [8c 8d] (a straight, Five to Nine)
1LATESHOW1 collected 3171 from pot
frankyhh_hh collected 3171 from pot
*** SUMMARY ***
Total pot 6342 | Rake 0 
Board [6s 9s 5h 3c 7d]
Seat 1: Fedayn72 folded before Flop (didn't bet)
Seat 2: vikim08 folded before Flop (didn't bet)
Seat 3: frankyhh_hh showed [8c 8d] and won (3171) with a straight, Five to Nine
Seat 4: Lotta<3 folded before Flop (didn't bet)
Seat 5: Kurre1 (button) folded on the Turn
Seat 6: Mr.Skapone (small blind) folded on the Flop
Seat 7: 1LATESHOW1 (big blind) showed [8s 5d] and won (3171) with a straight, Five to Nine
Seat 8: malik_msk folded on the River
Seat 9: 2NDclass folded before Flop (didn't bet)



PokerStars Game #69706956910: Tournament #544010396, $20+$2 USD Hold'em No Limit - Level VI (40/80) - 2011/10/29 21:02:47 MSK [2011/10/29 13:02:47 ET]
Table '544010396 89' 9-max Seat #6 is the button
Seat 1: Fedayn72 (1375 in chips) 
Seat 2: vikim08 (6886 in chips) 
Seat 3: frankyhh_hh (3882 in chips) 
Seat 4: Lotta<3 (3318 in chips) 
Seat 5: Kurre1 (1553 in chips) 
Seat 6: Mr.Skapone (3625 in chips) 
Seat 7: 1LATESHOW1 (3171 in chips) 
Seat 8: malik_msk (5679 in chips) 
Seat 9: 2NDclass (3266 in chips) 
Fedayn72: posts the ante 10
vikim08: posts the ante 10
frankyhh_hh: posts the ante 10
Lotta<3: posts the ante 10
Kurre1: posts the ante 10
Mr.Skapone: posts the ante 10
1LATESHOW1: posts the ante 10
malik_msk: posts the ante 10
2NDclass: posts the ante 10
1LATESHOW1: posts small blind 40
malik_msk: posts big blind 80
*** HOLE CARDS ***
Dealt to malik_msk [Jd 6s]
2NDclass: folds 
Fedayn72: folds 
vikim08: folds 
frankyhh_hh: folds 
Lotta<3: folds 
Kurre1: folds 
Mr.Skapone: raises 120 to 200
1LATESHOW1: folds 
malik_msk: folds 
Uncalled bet (120) returned to Mr.Skapone
Mr.Skapone collected 290 from pot
*** SUMMARY ***
Total pot 290 | Rake 0 
Seat 1: Fedayn72 folded before Flop (didn't bet)
Seat 2: vikim08 folded before Flop (didn't bet)
Seat 3: frankyhh_hh folded before Flop (didn't bet)
Seat 4: Lotta<3 folded before Flop (didn't bet)
Seat 5: Kurre1 folded before Flop (didn't bet)
Seat 6: Mr.Skapone (button) collected (290)
Seat 7: 1LATESHOW1 (small blind) folded before Flop
Seat 8: malik_msk (big blind) folded before Flop
Seat 9: 2NDclass folded before Flop (didn't bet)



PokerStars Game #69707000280: Tournament #544010396, $20+$2 USD Hold'em No Limit - Level VI (40/80) - 2011/10/29 21:03:38 MSK [2011/10/29 13:03:38 ET]
Table '544010396 89' 9-max Seat #7 is the button
Seat 1: Fedayn72 (1365 in chips) 
Seat 2: vikim08 (6876 in chips) 
Seat 3: frankyhh_hh (3872 in chips) 
Seat 4: Lotta<3 (3308 in chips) 
Seat 5: Kurre1 (1543 in chips) 
Seat 6: Mr.Skapone (3825 in chips) 
Seat 7: 1LATESHOW1 (3121 in chips) 
Seat 8: malik_msk (5589 in chips) 
Seat 9: 2NDclass (3256 in chips) 
Fedayn72: posts the ante 10
vikim08: posts the ante 10
frankyhh_hh: posts the ante 10
Lotta<3: posts the ante 10
Kurre1: posts the ante 10
Mr.Skapone: posts the ante 10
1LATESHOW1: posts the ante 10
malik_msk: posts the ante 10
2NDclass: posts the ante 10
malik_msk: posts small blind 40
2NDclass: posts big blind 80
*** HOLE CARDS ***
Dealt to malik_msk [6c Kc]
Fedayn72: folds 
vikim08: folds 
frankyhh_hh: folds 
Lotta<3: folds 
Kurre1: folds 
Mr.Skapone: raises 120 to 200
1LATESHOW1: folds 
malik_msk: calls 160
2NDclass: folds 
*** FLOP *** [Qh Ad Ts]
malik_msk: checks 
Mr.Skapone: bets 320
malik_msk: calls 320
*** TURN *** [Qh Ad Ts] [9d]
malik_msk: checks 
Mr.Skapone: checks 
*** RIVER *** [Qh Ad Ts 9d] [Qc]
malik_msk: bets 640
Mr.Skapone: folds 
Uncalled bet (640) returned to malik_msk
malik_msk collected 1210 from pot
malik_msk: doesn't show hand 
*** SUMMARY ***
Total pot 1210 | Rake 0 
Board [Qh Ad Ts 9d Qc]
Seat 1: Fedayn72 folded before Flop (didn't bet)
Seat 2: vikim08 folded before Flop (didn't bet)
Seat 3: frankyhh_hh folded before Flop (didn't bet)
Seat 4: Lotta<3 folded before Flop (didn't bet)
Seat 5: Kurre1 folded before Flop (didn't bet)
Seat 6: Mr.Skapone folded on the River
Seat 7: 1LATESHOW1 (button) folded before Flop (didn't bet)
Seat 8: malik_msk (small blind) collected (1210)
Seat 9: 2NDclass (big blind) folded before Flop



PokerStars Game #69707058981: Tournament #544010396, $20+$2 USD Hold'em No Limit - Level VI (40/80) - 2011/10/29 21:04:46 MSK [2011/10/29 13:04:46 ET]
Table '544010396 89' 9-max Seat #8 is the button
Seat 1: Fedayn72 (1355 in chips) 
Seat 2: vikim08 (6866 in chips) 
Seat 3: frankyhh_hh (3862 in chips) 
Seat 4: Lotta<3 (3298 in chips) 
Seat 5: Kurre1 (1533 in chips) 
Seat 6: Mr.Skapone (3295 in chips) 
Seat 7: 1LATESHOW1 (3111 in chips) 
Seat 8: malik_msk (6269 in chips) 
Seat 9: 2NDclass (3166 in chips) 
Fedayn72: posts the ante 10
vikim08: posts the ante 10
frankyhh_hh: posts the ante 10
Lotta<3: posts the ante 10
Kurre1: posts the ante 10
Mr.Skapone: posts the ante 10
1LATESHOW1: posts the ante 10
malik_msk: posts the ante 10
2NDclass: posts the ante 10
2NDclass: posts small blind 40
Fedayn72: posts big blind 80
*** HOLE CARDS ***
Dealt to malik_msk [Qd 3s]
vikim08: folds 
frankyhh_hh: calls 80
Lotta<3: raises 150 to 230
Kurre1: folds 
Mr.Skapone: folds 
1LATESHOW1: calls 230
malik_msk: folds 
2NDclass: folds 
Fedayn72: folds 
frankyhh_hh: calls 150
*** FLOP *** [4s Jd Jh]
frankyhh_hh: bets 160
Lotta<3: calls 160
1LATESHOW1: calls 160
*** TURN *** [4s Jd Jh] [Qc]
frankyhh_hh: checks 
Lotta<3: checks 
1LATESHOW1: bets 440
frankyhh_hh: folds 
Lotta<3: folds 
Uncalled bet (440) returned to 1LATESHOW1
1LATESHOW1 collected 1380 from pot
*** SUMMARY ***
Total pot 1380 | Rake 0 
Board [4s Jd Jh Qc]
Seat 1: Fedayn72 (big blind) folded before Flop
Seat 2: vikim08 folded before Flop (didn't bet)
Seat 3: frankyhh_hh folded on the Turn
Seat 4: Lotta<3 folded on the Turn
Seat 5: Kurre1 folded before Flop (didn't bet)
Seat 6: Mr.Skapone folded before Flop (didn't bet)
Seat 7: 1LATESHOW1 collected (1380)
Seat 8: malik_msk (button) folded before Flop (didn't bet)
Seat 9: 2NDclass (small blind) folded before Flop



PokerStars Game #69707165333: Tournament #544010396, $20+$2 USD Hold'em No Limit - Level VI (40/80) - 2011/10/29 21:06:47 MSK [2011/10/29 13:06:47 ET]
Table '544010396 89' 9-max Seat #9 is the button
Seat 1: Fedayn72 (1265 in chips) 
Seat 2: vikim08 (6856 in chips) 
Seat 3: frankyhh_hh (3462 in chips) 
Seat 4: Lotta<3 (2898 in chips) 
Seat 5: Kurre1 (1523 in chips) 
Seat 6: Mr.Skapone (3285 in chips) 
Seat 7: 1LATESHOW1 (4091 in chips) 
Seat 8: malik_msk (6259 in chips) 
Seat 9: 2NDclass (3116 in chips) 
Fedayn72: posts the ante 10
vikim08: posts the ante 10
frankyhh_hh: posts the ante 10
Lotta<3: posts the ante 10
Kurre1: posts the ante 10
Mr.Skapone: posts the ante 10
1LATESHOW1: posts the ante 10
malik_msk: posts the ante 10
2NDclass: posts the ante 10
Fedayn72: posts small blind 40
vikim08: posts big blind 80
*** HOLE CARDS ***
Dealt to malik_msk [2d 9h]
frankyhh_hh: calls 80
Lotta<3: folds 
Kurre1: calls 80
Mr.Skapone: folds 
1LATESHOW1: folds 
malik_msk: folds 
2NDclass: folds 
Fedayn72: folds 
vikim08: checks 
*** FLOP *** [Ts 3d 3h]
vikim08: checks 
frankyhh_hh: bets 160
Kurre1: folds 
vikim08: folds 
Uncalled bet (160) returned to frankyhh_hh
frankyhh_hh collected 370 from pot
*** SUMMARY ***
Total pot 370 | Rake 0 
Board [Ts 3d 3h]
Seat 1: Fedayn72 (small blind) folded before Flop
Seat 2: vikim08 (big blind) folded on the Flop
Seat 3: frankyhh_hh collected (370)
Seat 4: Lotta<3 folded before Flop (didn't bet)
Seat 5: Kurre1 folded on the Flop
Seat 6: Mr.Skapone folded before Flop (didn't bet)
Seat 7: 1LATESHOW1 folded before Flop (didn't bet)
Seat 8: malik_msk folded before Flop (didn't bet)
Seat 9: 2NDclass (button) folded before Flop (didn't bet)



PokerStars Game #69707203625: Tournament #544010396, $20+$2 USD Hold'em No Limit - Level VII (50/100) - 2011/10/29 21:07:31 MSK [2011/10/29 13:07:31 ET]
Table '544010396 89' 9-max Seat #1 is the button
Seat 1: Fedayn72 (1215 in chips) 
Seat 2: vikim08 (6766 in chips) 
Seat 3: frankyhh_hh (3742 in chips) 
Seat 4: Lotta<3 (2888 in chips) 
Seat 5: Kurre1 (1433 in chips) 
Seat 6: Mr.Skapone (3275 in chips) 
Seat 7: 1LATESHOW1 (4081 in chips) 
Seat 8: malik_msk (6249 in chips) 
Seat 9: 2NDclass (3106 in chips) 
Fedayn72: posts the ante 10
vikim08: posts the ante 10
frankyhh_hh: posts the ante 10
Lotta<3: posts the ante 10
Kurre1: posts the ante 10
Mr.Skapone: posts the ante 10
1LATESHOW1: posts the ante 10
malik_msk: posts the ante 10
2NDclass: posts the ante 10
vikim08: posts small blind 50
frankyhh_hh: posts big blind 100
*** HOLE CARDS ***
Dealt to malik_msk [Tc Ah]
Lotta<3: folds 
Kurre1: calls 100
Mr.Skapone: calls 100
1LATESHOW1: calls 100
malik_msk: calls 100
2NDclass: folds 
Fedayn72: folds 
vikim08: calls 50
frankyhh_hh: checks 
*** FLOP *** [2d 2h 9s]
vikim08: checks 
frankyhh_hh: bets 200
Kurre1: folds 
Mr.Skapone: folds 
1LATESHOW1: folds 
malik_msk: folds 
vikim08: folds 
Uncalled bet (200) returned to frankyhh_hh
frankyhh_hh collected 690 from pot
*** SUMMARY ***
Total pot 690 | Rake 0 
Board [2d 2h 9s]
Seat 1: Fedayn72 (button) folded before Flop (didn't bet)
Seat 2: vikim08 (small blind) folded on the Flop
Seat 3: frankyhh_hh (big blind) collected (690)
Seat 4: Lotta<3 folded before Flop (didn't bet)
Seat 5: Kurre1 folded on the Flop
Seat 6: Mr.Skapone folded on the Flop
Seat 7: 1LATESHOW1 folded on the Flop
Seat 8: malik_msk folded on the Flop
Seat 9: 2NDclass folded before Flop (didn't bet)



PokerStars Game #69707259810: Tournament #544010396, $20+$2 USD Hold'em No Limit - Level VII (50/100) - 2011/10/29 21:08:35 MSK [2011/10/29 13:08:35 ET]
Table '544010396 89' 9-max Seat #2 is the button
Seat 1: Fedayn72 (1205 in chips) 
Seat 2: vikim08 (6656 in chips) 
Seat 3: frankyhh_hh (4322 in chips) 
Seat 4: Lotta<3 (2878 in chips) 
Seat 5: Kurre1 (1323 in chips) 
Seat 6: Mr.Skapone (3165 in chips) 
Seat 7: 1LATESHOW1 (3971 in chips) 
Seat 8: malik_msk (6139 in chips) 
Seat 9: 2NDclass (3096 in chips) 
Fedayn72: posts the ante 10
vikim08: posts the ante 10
frankyhh_hh: posts the ante 10
Lotta<3: posts the ante 10
Kurre1: posts the ante 10
Mr.Skapone: posts the ante 10
1LATESHOW1: posts the ante 10
malik_msk: posts the ante 10
2NDclass: posts the ante 10
frankyhh_hh: posts small blind 50
Lotta<3: posts big blind 100
*** HOLE CARDS ***
Dealt to malik_msk [Ad Tc]
Kurre1: folds 
Mr.Skapone: folds 
1LATESHOW1: folds 
malik_msk: calls 100
2NDclass: folds 
Fedayn72: folds 
vikim08: folds 
frankyhh_hh: calls 50
Lotta<3: checks 
*** FLOP *** [Qc Qd 6h]
frankyhh_hh: checks 
Lotta<3: checks 
malik_msk: checks 
*** TURN *** [Qc Qd 6h] [7s]
frankyhh_hh: checks 
Lotta<3: checks 
malik_msk: bets 300
frankyhh_hh: folds 
Lotta<3: folds 
Uncalled bet (300) returned to malik_msk
malik_msk collected 390 from pot
malik_msk: doesn't show hand 
*** SUMMARY ***
Total pot 390 | Rake 0 
Board [Qc Qd 6h 7s]
Seat 1: Fedayn72 folded before Flop (didn't bet)
Seat 2: vikim08 (button) folded before Flop (didn't bet)
Seat 3: frankyhh_hh (small blind) folded on the Turn
Seat 4: Lotta<3 (big blind) folded on the Turn
Seat 5: Kurre1 folded before Flop (didn't bet)
Seat 6: Mr.Skapone folded before Flop (didn't bet)
Seat 7: 1LATESHOW1 folded before Flop (didn't bet)
Seat 8: malik_msk collected (390)
Seat 9: 2NDclass folded before Flop (didn't bet)



PokerStars Game #69707332760: Tournament #544010396, $20+$2 USD Hold'em No Limit - Level VII (50/100) - 2011/10/29 21:10:00 MSK [2011/10/29 13:10:00 ET]
Table '544010396 89' 9-max Seat #3 is the button
Seat 1: Fedayn72 (1195 in chips) 
Seat 2: vikim08 (6646 in chips) 
Seat 3: frankyhh_hh (4212 in chips) 
Seat 4: Lotta<3 (2768 in chips) 
Seat 5: Kurre1 (1313 in chips) 
Seat 6: Mr.Skapone (3155 in chips) 
Seat 7: 1LATESHOW1 (3961 in chips) 
Seat 8: malik_msk (6419 in chips) 
Seat 9: 2NDclass (3086 in chips) 
Fedayn72: posts the ante 10
vikim08: posts the ante 10
frankyhh_hh: posts the ante 10
Lotta<3: posts the ante 10
Kurre1: posts the ante 10
Mr.Skapone: posts the ante 10
1LATESHOW1: posts the ante 10
malik_msk: posts the ante 10
2NDclass: posts the ante 10
Lotta<3: posts small blind 50
Kurre1: posts big blind 100
*** HOLE CARDS ***
Dealt to malik_msk [6c 3h]
Mr.Skapone: folds 
1LATESHOW1: folds 
malik_msk: folds 
2NDclass: folds 
Fedayn72: folds 
vikim08: folds 
frankyhh_hh: folds 
Lotta<3: folds 
Uncalled bet (50) returned to Kurre1
Kurre1 collected 190 from pot
*** SUMMARY ***
Total pot 190 | Rake 0 
Seat 1: Fedayn72 folded before Flop (didn't bet)
Seat 2: vikim08 folded before Flop (didn't bet)
Seat 3: frankyhh_hh (button) folded before Flop (didn't bet)
Seat 4: Lotta<3 (small blind) folded before Flop
Seat 5: Kurre1 (big blind) collected (190)
Seat 6: Mr.Skapone folded before Flop (didn't bet)
Seat 7: 1LATESHOW1 folded before Flop (didn't bet)
Seat 8: malik_msk folded before Flop (didn't bet)
Seat 9: 2NDclass folded before Flop (didn't bet)



PokerStars Game #69707356566: Tournament #544010396, $20+$2 USD Hold'em No Limit - Level VII (50/100) - 2011/10/29 21:10:27 MSK [2011/10/29 13:10:27 ET]
Table '544010396 89' 9-max Seat #4 is the button
Seat 1: Fedayn72 (1185 in chips) 
Seat 2: vikim08 (6636 in chips) 
Seat 3: frankyhh_hh (4202 in chips) 
Seat 4: Lotta<3 (2708 in chips) 
Seat 5: Kurre1 (1443 in chips) 
Seat 6: Mr.Skapone (3145 in chips) 
Seat 7: 1LATESHOW1 (3951 in chips) 
Seat 8: malik_msk (6409 in chips) 
Seat 9: 2NDclass (3076 in chips) 
Fedayn72: posts the ante 10
vikim08: posts the ante 10
frankyhh_hh: posts the ante 10
Lotta<3: posts the ante 10
Kurre1: posts the ante 10
Mr.Skapone: posts the ante 10
1LATESHOW1: posts the ante 10
malik_msk: posts the ante 10
2NDclass: posts the ante 10
Kurre1: posts small blind 50
Mr.Skapone: posts big blind 100
*** HOLE CARDS ***
Dealt to malik_msk [Jc 9d]
1LATESHOW1: folds 
malik_msk: raises 100 to 200
2NDclass: folds 
Fedayn72: folds 
vikim08: folds 
frankyhh_hh: folds 
Lotta<3: folds 
Kurre1: calls 150
Mr.Skapone: calls 100
*** FLOP *** [8h 3c Jh]
Kurre1: checks 
Mr.Skapone: checks 
malik_msk: bets 500
Kurre1: folds 
Mr.Skapone: folds 
Uncalled bet (500) returned to malik_msk
malik_msk collected 690 from pot
malik_msk: doesn't show hand 
*** SUMMARY ***
Total pot 690 | Rake 0 
Board [8h 3c Jh]
Seat 1: Fedayn72 folded before Flop (didn't bet)
Seat 2: vikim08 folded before Flop (didn't bet)
Seat 3: frankyhh_hh folded before Flop (didn't bet)
Seat 4: Lotta<3 (button) folded before Flop (didn't bet)
Seat 5: Kurre1 (small blind) folded on the Flop
Seat 6: Mr.Skapone (big blind) folded on the Flop
Seat 7: 1LATESHOW1 folded before Flop (didn't bet)
Seat 8: malik_msk collected (690)
Seat 9: 2NDclass folded before Flop (didn't bet)



PokerStars Game #69707446978: Tournament #544010396, $20+$2 USD Hold'em No Limit - Level VII (50/100) - 2011/10/29 21:12:12 MSK [2011/10/29 13:12:12 ET]
Table '544010396 89' 9-max Seat #5 is the button
Seat 1: Fedayn72 (1175 in chips) 
Seat 2: vikim08 (6626 in chips) 
Seat 3: frankyhh_hh (4192 in chips) 
Seat 4: Lotta<3 (2698 in chips) 
Seat 5: Kurre1 (1233 in chips) 
Seat 6: Mr.Skapone (2935 in chips) 
Seat 7: 1LATESHOW1 (3941 in chips) 
Seat 8: malik_msk (6889 in chips) 
Seat 9: 2NDclass (3066 in chips) 
Fedayn72: posts the ante 10
vikim08: posts the ante 10
frankyhh_hh: posts the ante 10
Lotta<3: posts the ante 10
Kurre1: posts the ante 10
Mr.Skapone: posts the ante 10
1LATESHOW1: posts the ante 10
malik_msk: posts the ante 10
2NDclass: posts the ante 10
Mr.Skapone: posts small blind 50
1LATESHOW1: posts big blind 100
*** HOLE CARDS ***
Dealt to malik_msk [2s 9c]
malik_msk: folds 
2NDclass: raises 100 to 200
Fedayn72: folds 
vikim08: folds 
frankyhh_hh: calls 200
Lotta<3: folds 
Kurre1: folds 
Mr.Skapone: calls 150
1LATESHOW1: folds 
*** FLOP *** [2d 9s 6s]
Mr.Skapone: checks 
2NDclass: checks 
frankyhh_hh: checks 
*** TURN *** [2d 9s 6s] [6d]
Mr.Skapone: bets 400
2NDclass: folds 
frankyhh_hh: calls 400
*** RIVER *** [2d 9s 6s 6d] [5h]
Mr.Skapone: bets 300
frankyhh_hh: raises 600 to 900
Mr.Skapone: folds 
Uncalled bet (600) returned to frankyhh_hh
frankyhh_hh collected 2190 from pot
*** SUMMARY ***
Total pot 2190 | Rake 0 
Board [2d 9s 6s 6d 5h]
Seat 1: Fedayn72 folded before Flop (didn't bet)
Seat 2: vikim08 folded before Flop (didn't bet)
Seat 3: frankyhh_hh collected (2190)
Seat 4: Lotta<3 folded before Flop (didn't bet)
Seat 5: Kurre1 (button) folded before Flop (didn't bet)
Seat 6: Mr.Skapone (small blind) folded on the River
Seat 7: 1LATESHOW1 (big blind) folded before Flop
Seat 8: malik_msk folded before Flop (didn't bet)
Seat 9: 2NDclass folded on the Turn



PokerStars Game #69707534909: Tournament #544010396, $20+$2 USD Hold'em No Limit - Level VII (50/100) - 2011/10/29 21:13:54 MSK [2011/10/29 13:13:54 ET]
Table '544010396 89' 9-max Seat #6 is the button
Seat 1: Fedayn72 (1165 in chips) 
Seat 2: vikim08 (6616 in chips) 
Seat 3: frankyhh_hh (5472 in chips) 
Seat 4: Lotta<3 (2688 in chips) 
Seat 5: Kurre1 (1223 in chips) 
Seat 6: Mr.Skapone (2025 in chips) 
Seat 7: 1LATESHOW1 (3831 in chips) 
Seat 8: malik_msk (6879 in chips) 
Seat 9: 2NDclass (2856 in chips) 
Fedayn72: posts the ante 10
vikim08: posts the ante 10
frankyhh_hh: posts the ante 10
Lotta<3: posts the ante 10
Kurre1: posts the ante 10
Mr.Skapone: posts the ante 10
1LATESHOW1: posts the ante 10
malik_msk: posts the ante 10
2NDclass: posts the ante 10
1LATESHOW1: posts small blind 50
malik_msk: posts big blind 100
*** HOLE CARDS ***
Dealt to malik_msk [3d 4s]
2NDclass: raises 200 to 300
Fedayn72: folds 
vikim08: folds 
frankyhh_hh: folds 
Lotta<3: folds 
Kurre1: calls 300
Mr.Skapone: raises 500 to 800
1LATESHOW1: folds 
malik_msk: folds 
2NDclass: raises 2046 to 2846 and is all-in
Kurre1: calls 913 and is all-in
Mr.Skapone: calls 1215 and is all-in
Uncalled bet (831) returned to 2NDclass
*** FLOP *** [2d 3h 7h]
*** TURN *** [2d 3h 7h] [Ts]
*** RIVER *** [2d 3h 7h Ts] [Kd]
*** SHOW DOWN ***
2NDclass: shows [9d 9h] (a pair of Nines)
Mr.Skapone: shows [Ac Ad] (a pair of Aces)
Mr.Skapone collected 1604 from side pot
Kurre1: shows [5c 6c] (high card King)
Mr.Skapone collected 3879 from main pot
Kurre1 finished the tournament in 1956th place
*** SUMMARY ***
Total pot 5483 Main pot 3879. Side pot 1604. | Rake 0 
Board [2d 3h 7h Ts Kd]
Seat 1: Fedayn72 folded before Flop (didn't bet)
Seat 2: vikim08 folded before Flop (didn't bet)
Seat 3: frankyhh_hh folded before Flop (didn't bet)
Seat 4: Lotta<3 folded before Flop (didn't bet)
Seat 5: Kurre1 showed [5c 6c] and lost with high card King
Seat 6: Mr.Skapone (button) showed [Ac Ad] and won (5483) with a pair of Aces
Seat 7: 1LATESHOW1 (small blind) folded before Flop
Seat 8: malik_msk (big blind) folded before Flop
Seat 9: 2NDclass showed [9d 9h] and lost with a pair of Nines



PokerStars Game #69707590745: Tournament #544010396, $20+$2 USD Hold'em No Limit - Level VII (50/100) - 2011/10/29 21:14:59 MSK [2011/10/29 13:14:59 ET]
Table '544010396 89' 9-max Seat #7 is the button
Seat 1: Fedayn72 (1155 in chips) 
Seat 2: vikim08 (6606 in chips) 
Seat 3: frankyhh_hh (5462 in chips) 
Seat 4: Lotta<3 (2678 in chips) 
Seat 6: Mr.Skapone (5483 in chips) 
Seat 7: 1LATESHOW1 (3771 in chips) 
Seat 8: malik_msk (6769 in chips) 
Seat 9: 2NDclass (831 in chips) 
Fedayn72: posts the ante 10
vikim08: posts the ante 10
frankyhh_hh: posts the ante 10
Lotta<3: posts the ante 10
Mr.Skapone: posts the ante 10
1LATESHOW1: posts the ante 10
malik_msk: posts the ante 10
2NDclass: posts the ante 10
malik_msk: posts small blind 50
2NDclass: posts big blind 100
*** HOLE CARDS ***
Dealt to malik_msk [6s 9s]
Merceko is connected 
Fedayn72: folds 
vikim08: folds 
frankyhh_hh: folds 
Lotta<3: folds 
Mr.Skapone: folds 
1LATESHOW1: folds 
malik_msk: calls 50
2NDclass: raises 721 to 821 and is all-in
malik_msk: calls 721
*** FLOP *** [Jd Ts 2c]
*** TURN *** [Jd Ts 2c] [9c]
*** RIVER *** [Jd Ts 2c 9c] [8s]
*** SHOW DOWN ***
malik_msk: shows [6s 9s] (a pair of Nines)
2NDclass: shows [Ah Th] (a pair of Tens)
2NDclass collected 1722 from pot
*** SUMMARY ***
Total pot 1722 | Rake 0 
Board [Jd Ts 2c 9c 8s]
Seat 1: Fedayn72 folded before Flop (didn't bet)
Seat 2: vikim08 folded before Flop (didn't bet)
Seat 3: frankyhh_hh folded before Flop (didn't bet)
Seat 4: Lotta<3 folded before Flop (didn't bet)
Seat 6: Mr.Skapone folded before Flop (didn't bet)
Seat 7: 1LATESHOW1 (button) folded before Flop (didn't bet)
Seat 8: malik_msk (small blind) showed [6s 9s] and lost with a pair of Nines
Seat 9: 2NDclass (big blind) showed [Ah Th] and won (1722) with a pair of Tens



PokerStars Game #69707634298: Tournament #544010396, $20+$2 USD Hold'em No Limit - Level VII (50/100) - 2011/10/29 21:15:50 MSK [2011/10/29 13:15:50 ET]
Table '544010396 89' 9-max Seat #8 is the button
Seat 1: Fedayn72 (1145 in chips) 
Seat 2: vikim08 (6596 in chips) 
Seat 3: frankyhh_hh (5452 in chips) 
Seat 4: Lotta<3 (2668 in chips) 
Seat 5: Merceko (4518 in chips) 
Seat 6: Mr.Skapone (5473 in chips) 
Seat 7: 1LATESHOW1 (3761 in chips) 
Seat 8: malik_msk (5938 in chips) 
Seat 9: 2NDclass (1722 in chips) 
Fedayn72: posts the ante 10
vikim08: posts the ante 10
frankyhh_hh: posts the ante 10
Lotta<3: posts the ante 10
Merceko: posts the ante 10
Mr.Skapone: posts the ante 10
1LATESHOW1: posts the ante 10
malik_msk: posts the ante 10
2NDclass: posts the ante 10
2NDclass: posts small blind 50
Fedayn72: posts big blind 100
*** HOLE CARDS ***
Dealt to malik_msk [2s Qd]
vikim08: folds 
frankyhh_hh: folds 
Lotta<3: folds 
Merceko: folds 
Mr.Skapone: folds 
1LATESHOW1: folds 
malik_msk: folds 
2NDclass: folds 
Uncalled bet (50) returned to Fedayn72
Fedayn72 collected 190 from pot
Fedayn72: doesn't show hand 
*** SUMMARY ***
Total pot 190 | Rake 0 
Seat 1: Fedayn72 (big blind) collected (190)
Seat 2: vikim08 folded before Flop (didn't bet)
Seat 3: frankyhh_hh folded before Flop (didn't bet)
Seat 4: Lotta<3 folded before Flop (didn't bet)
Seat 5: Merceko folded before Flop (didn't bet)
Seat 6: Mr.Skapone folded before Flop (didn't bet)
Seat 7: 1LATESHOW1 folded before Flop (didn't bet)
Seat 8: malik_msk (button) folded before Flop (didn't bet)
Seat 9: 2NDclass (small blind) folded before Flop



PokerStars Game #69707655069: Tournament #544010396, $20+$2 USD Hold'em No Limit - Level VII (50/100) - 2011/10/29 21:16:14 MSK [2011/10/29 13:16:14 ET]
Table '544010396 89' 9-max Seat #9 is the button
Seat 1: Fedayn72 (1275 in chips) 
Seat 2: vikim08 (6586 in chips) 
Seat 3: frankyhh_hh (5442 in chips) 
Seat 4: Lotta<3 (2658 in chips) 
Seat 5: Merceko (4508 in chips) 
Seat 6: Mr.Skapone (5463 in chips) 
Seat 7: 1LATESHOW1 (3751 in chips) 
Seat 8: malik_msk (5928 in chips) 
Seat 9: 2NDclass (1662 in chips) 
Fedayn72: posts the ante 10
vikim08: posts the ante 10
frankyhh_hh: posts the ante 10
Lotta<3: posts the ante 10
Merceko: posts the ante 10
Mr.Skapone: posts the ante 10
1LATESHOW1: posts the ante 10
malik_msk: posts the ante 10
2NDclass: posts the ante 10
Fedayn72: posts small blind 50
vikim08: posts big blind 100
*** HOLE CARDS ***
Dealt to malik_msk [5s 8s]
frankyhh_hh: folds 
Lotta<3: folds 
Merceko: folds 
Mr.Skapone: folds 
1LATESHOW1: folds 
malik_msk: calls 100
2NDclass: folds 
Fedayn72: folds 
vikim08: checks 
*** FLOP *** [7d 8d Ah]
vikim08: checks 
malik_msk: bets 100
vikim08: raises 300 to 400
malik_msk: calls 300
*** TURN *** [7d 8d Ah] [5d]
vikim08: bets 700
malik_msk: raises 1300 to 2000
vikim08 has timed out
vikim08: folds 
Uncalled bet (1300) returned to malik_msk
vikim08 is sitting out
malik_msk collected 2540 from pot
malik_msk: doesn't show hand 
vikim08 has returned
*** SUMMARY ***
Total pot 2540 | Rake 0 
Board [7d 8d Ah 5d]
Seat 1: Fedayn72 (small blind) folded before Flop
Seat 2: vikim08 (big blind) folded on the Turn
Seat 3: frankyhh_hh folded before Flop (didn't bet)
Seat 4: Lotta<3 folded before Flop (didn't bet)
Seat 5: Merceko folded before Flop (didn't bet)
Seat 6: Mr.Skapone folded before Flop (didn't bet)
Seat 7: 1LATESHOW1 folded before Flop (didn't bet)
Seat 8: malik_msk collected (2540)
Seat 9: 2NDclass (button) folded before Flop (didn't bet)



PokerStars Game #69707735954: Tournament #544010396, $20+$2 USD Hold'em No Limit - Level VIII (60/120) - 2011/10/29 21:17:48 MSK [2011/10/29 13:17:48 ET]
Table '544010396 89' 9-max Seat #1 is the button
Seat 1: Fedayn72 (1215 in chips) 
Seat 2: vikim08 (5376 in chips) 
Seat 3: frankyhh_hh (5432 in chips) 
Seat 4: Lotta<3 (2648 in chips) 
Seat 5: Merceko (4498 in chips) 
Seat 6: Mr.Skapone (5453 in chips) 
Seat 7: 1LATESHOW1 (3741 in chips) 
Seat 8: malik_msk (7258 in chips) 
Seat 9: 2NDclass (1652 in chips) 
Fedayn72: posts the ante 15
vikim08: posts the ante 15
frankyhh_hh: posts the ante 15
Lotta<3: posts the ante 15
Merceko: posts the ante 15
Mr.Skapone: posts the ante 15
1LATESHOW1: posts the ante 15
malik_msk: posts the ante 15
2NDclass: posts the ante 15
vikim08: posts small blind 60
frankyhh_hh: posts big blind 120
*** HOLE CARDS ***
Dealt to malik_msk [9d Qh]
Lotta<3: folds 
Merceko: folds 
Mr.Skapone: folds 
1LATESHOW1: folds 
malik_msk: folds 
2NDclass: raises 1517 to 1637 and is all-in
Fedayn72: folds 
vikim08: folds 
frankyhh_hh: folds 
Uncalled bet (1517) returned to 2NDclass
2NDclass collected 435 from pot
*** SUMMARY ***
Total pot 435 | Rake 0 
Seat 1: Fedayn72 (button) folded before Flop (didn't bet)
Seat 2: vikim08 (small blind) folded before Flop
Seat 3: frankyhh_hh (big blind) folded before Flop
Seat 4: Lotta<3 folded before Flop (didn't bet)
Seat 5: Merceko folded before Flop (didn't bet)
Seat 6: Mr.Skapone folded before Flop (didn't bet)
Seat 7: 1LATESHOW1 folded before Flop (didn't bet)
Seat 8: malik_msk folded before Flop (didn't bet)
Seat 9: 2NDclass collected (435)



PokerStars Game #69707754951: Tournament #544010396, $20+$2 USD Hold'em No Limit - Level VIII (60/120) - 2011/10/29 21:18:10 MSK [2011/10/29 13:18:10 ET]
Table '544010396 89' 9-max Seat #2 is the button
Seat 1: Fedayn72 (1200 in chips) 
Seat 2: vikim08 (5301 in chips) 
Seat 3: frankyhh_hh (5297 in chips) 
Seat 4: Lotta<3 (2633 in chips) 
Seat 5: Merceko (4483 in chips) 
Seat 6: Mr.Skapone (5438 in chips) 
Seat 7: 1LATESHOW1 (3726 in chips) 
Seat 8: malik_msk (7243 in chips) 
Seat 9: 2NDclass (1952 in chips) 
Fedayn72: posts the ante 15
vikim08: posts the ante 15
frankyhh_hh: posts the ante 15
Lotta<3: posts the ante 15
Merceko: posts the ante 15
Mr.Skapone: posts the ante 15
1LATESHOW1: posts the ante 15
malik_msk: posts the ante 15
2NDclass: posts the ante 15
frankyhh_hh: posts small blind 60
Lotta<3: posts big blind 120
*** HOLE CARDS ***
Dealt to malik_msk [Ad Qd]
Merceko: folds 
Mr.Skapone: folds 
1LATESHOW1: folds 
malik_msk: raises 240 to 360
2NDclass: folds 
Fedayn72: folds 
vikim08: folds 
frankyhh_hh: folds 
Lotta<3: folds 
Uncalled bet (240) returned to malik_msk
malik_msk collected 435 from pot
malik_msk: doesn't show hand 
*** SUMMARY ***
Total pot 435 | Rake 0 
Seat 1: Fedayn72 folded before Flop (didn't bet)
Seat 2: vikim08 (button) folded before Flop (didn't bet)
Seat 3: frankyhh_hh (small blind) folded before Flop
Seat 4: Lotta<3 (big blind) folded before Flop
Seat 5: Merceko folded before Flop (didn't bet)
Seat 6: Mr.Skapone folded before Flop (didn't bet)
Seat 7: 1LATESHOW1 folded before Flop (didn't bet)
Seat 8: malik_msk collected (435)
Seat 9: 2NDclass folded before Flop (didn't bet)



PokerStars Game #69707786623: Tournament #544010396, $20+$2 USD Hold'em No Limit - Level VIII (60/120) - 2011/10/29 21:18:47 MSK [2011/10/29 13:18:47 ET]
Table '544010396 89' 9-max Seat #3 is the button
Seat 1: Fedayn72 (1185 in chips) 
Seat 2: vikim08 (5286 in chips) 
Seat 3: frankyhh_hh (5222 in chips) 
Seat 4: Lotta<3 (2498 in chips) 
Seat 5: Merceko (4468 in chips) 
Seat 6: Mr.Skapone (5423 in chips) 
Seat 7: 1LATESHOW1 (3711 in chips) 
Seat 8: malik_msk (7543 in chips) 
Seat 9: 2NDclass (1937 in chips) 
Fedayn72: posts the ante 15
vikim08: posts the ante 15
frankyhh_hh: posts the ante 15
Lotta<3: posts the ante 15
Merceko: posts the ante 15
Mr.Skapone: posts the ante 15
1LATESHOW1: posts the ante 15
malik_msk: posts the ante 15
2NDclass: posts the ante 15
Lotta<3: posts small blind 60
Merceko: posts big blind 120
*** HOLE CARDS ***
Dealt to malik_msk [8s As]
Mr.Skapone: raises 180 to 300
1LATESHOW1: folds 
malik_msk: folds 
2NDclass: folds 
Fedayn72: folds 
vikim08: folds 
frankyhh_hh: folds 
Lotta<3: folds 
Merceko: folds 
Uncalled bet (180) returned to Mr.Skapone
Mr.Skapone collected 435 from pot
*** SUMMARY ***
Total pot 435 | Rake 0 
Seat 1: Fedayn72 folded before Flop (didn't bet)
Seat 2: vikim08 folded before Flop (didn't bet)
Seat 3: frankyhh_hh (button) folded before Flop (didn't bet)
Seat 4: Lotta<3 (small blind) folded before Flop
Seat 5: Merceko (big blind) folded before Flop
Seat 6: Mr.Skapone collected (435)
Seat 7: 1LATESHOW1 folded before Flop (didn't bet)
Seat 8: malik_msk folded before Flop (didn't bet)
Seat 9: 2NDclass folded before Flop (didn't bet)



PokerStars Game #69707813484: Tournament #544010396, $20+$2 USD Hold'em No Limit - Level VIII (60/120) - 2011/10/29 21:19:18 MSK [2011/10/29 13:19:18 ET]
Table '544010396 89' 9-max Seat #4 is the button
Seat 1: Fedayn72 (1170 in chips) 
Seat 2: vikim08 (5271 in chips) 
Seat 3: frankyhh_hh (5207 in chips) 
Seat 4: Lotta<3 (2423 in chips) 
Seat 5: Merceko (4333 in chips) 
Seat 6: Mr.Skapone (5723 in chips) 
Seat 7: 1LATESHOW1 (3696 in chips) 
Seat 8: malik_msk (7528 in chips) 
Seat 9: 2NDclass (1922 in chips) 
Fedayn72: posts the ante 15
vikim08: posts the ante 15
frankyhh_hh: posts the ante 15
Lotta<3: posts the ante 15
Merceko: posts the ante 15
Mr.Skapone: posts the ante 15
1LATESHOW1: posts the ante 15
malik_msk: posts the ante 15
2NDclass: posts the ante 15
Merceko: posts small blind 60
Mr.Skapone: posts big blind 120
*** HOLE CARDS ***
Dealt to malik_msk [3h 8d]
1LATESHOW1: folds 
malik_msk: folds 
2NDclass: raises 120 to 240
Fedayn72: folds 
vikim08: folds 
frankyhh_hh: folds 
Lotta<3: folds 
Merceko: folds 
Mr.Skapone: calls 120
*** FLOP *** [9d 3s Td]
Mr.Skapone: checks 
2NDclass: checks 
*** TURN *** [9d 3s Td] [Ts]
Mr.Skapone: checks 
2NDclass: bets 310
Mr.Skapone: folds 
Uncalled bet (310) returned to 2NDclass
2NDclass collected 675 from pot
*** SUMMARY ***
Total pot 675 | Rake 0 
Board [9d 3s Td Ts]
Seat 1: Fedayn72 folded before Flop (didn't bet)
Seat 2: vikim08 folded before Flop (didn't bet)
Seat 3: frankyhh_hh folded before Flop (didn't bet)
Seat 4: Lotta<3 (button) folded before Flop (didn't bet)
Seat 5: Merceko (small blind) folded before Flop
Seat 6: Mr.Skapone (big blind) folded on the Turn
Seat 7: 1LATESHOW1 folded before Flop (didn't bet)
Seat 8: malik_msk folded before Flop (didn't bet)
Seat 9: 2NDclass collected (675)



PokerStars Game #69707852777: Tournament #544010396, $20+$2 USD Hold'em No Limit - Level VIII (60/120) - 2011/10/29 21:20:04 MSK [2011/10/29 13:20:04 ET]
Table '544010396 89' 9-max Seat #5 is the button
Seat 1: Fedayn72 (1155 in chips) 
Seat 2: vikim08 (5256 in chips) 
Seat 3: frankyhh_hh (5192 in chips) 
Seat 4: Lotta<3 (2408 in chips) 
Seat 5: Merceko (4258 in chips) 
Seat 6: Mr.Skapone (5468 in chips) 
Seat 7: 1LATESHOW1 (3681 in chips) 
Seat 8: malik_msk (7513 in chips) 
Seat 9: 2NDclass (2342 in chips) 
Fedayn72: posts the ante 15
vikim08: posts the ante 15
frankyhh_hh: posts the ante 15
Lotta<3: posts the ante 15
Merceko: posts the ante 15
Mr.Skapone: posts the ante 15
1LATESHOW1: posts the ante 15
malik_msk: posts the ante 15
2NDclass: posts the ante 15
Mr.Skapone: posts small blind 60
1LATESHOW1: posts big blind 120
*** HOLE CARDS ***
Dealt to malik_msk [Th 3c]
malik_msk: folds 
2NDclass: folds 
Fedayn72: folds 
vikim08: folds 
frankyhh_hh: raises 240 to 360
Lotta<3: folds 
Merceko: folds 
Mr.Skapone: folds 
1LATESHOW1: folds 
Uncalled bet (240) returned to frankyhh_hh
frankyhh_hh collected 435 from pot
*** SUMMARY ***
Total pot 435 | Rake 0 
Seat 1: Fedayn72 folded before Flop (didn't bet)
Seat 2: vikim08 folded before Flop (didn't bet)
Seat 3: frankyhh_hh collected (435)
Seat 4: Lotta<3 folded before Flop (didn't bet)
Seat 5: Merceko (button) folded before Flop (didn't bet)
Seat 6: Mr.Skapone (small blind) folded before Flop
Seat 7: 1LATESHOW1 (big blind) folded before Flop
Seat 8: malik_msk folded before Flop (didn't bet)
Seat 9: 2NDclass folded before Flop (didn't bet)



PokerStars Game #69707874780: Tournament #544010396, $20+$2 USD Hold'em No Limit - Level VIII (60/120) - 2011/10/29 21:20:30 MSK [2011/10/29 13:20:30 ET]
Table '544010396 89' 9-max Seat #6 is the button
Seat 1: Fedayn72 (1140 in chips) 
Seat 2: vikim08 (5241 in chips) 
Seat 3: frankyhh_hh (5492 in chips) 
Seat 4: Lotta<3 (2393 in chips) 
Seat 5: Merceko (4243 in chips) 
Seat 6: Mr.Skapone (5393 in chips) 
Seat 7: 1LATESHOW1 (3546 in chips) 
Seat 8: malik_msk (7498 in chips) 
Seat 9: 2NDclass (2327 in chips) 
Fedayn72: posts the ante 15
vikim08: posts the ante 15
frankyhh_hh: posts the ante 15
Lotta<3: posts the ante 15
Merceko: posts the ante 15
Mr.Skapone: posts the ante 15
1LATESHOW1: posts the ante 15
malik_msk: posts the ante 15
2NDclass: posts the ante 15
1LATESHOW1: posts small blind 60
malik_msk: posts big blind 120
*** HOLE CARDS ***
Dealt to malik_msk [6d Kd]
2NDclass: folds 
Fedayn72: raises 1005 to 1125 and is all-in
vikim08: folds 
frankyhh_hh: folds 
Lotta<3: folds 
Merceko: folds 
Mr.Skapone: folds 
1LATESHOW1: folds 
malik_msk: calls 1005
*** FLOP *** [5s 2c 3s]
*** TURN *** [5s 2c 3s] [4c]
*** RIVER *** [5s 2c 3s 4c] [8d]
*** SHOW DOWN ***
malik_msk: shows [6d Kd] (a straight, Deuce to Six)
Fedayn72: shows [Qd As] (a straight, Ace to Five)
malik_msk collected 2445 from pot
Fedayn72 finished the tournament in 1804th place
*** SUMMARY ***
Total pot 2445 | Rake 0 
Board [5s 2c 3s 4c 8d]
Seat 1: Fedayn72 showed [Qd As] and lost with a straight, Ace to Five
Seat 2: vikim08 folded before Flop (didn't bet)
Seat 3: frankyhh_hh folded before Flop (didn't bet)
Seat 4: Lotta<3 folded before Flop (didn't bet)
Seat 5: Merceko folded before Flop (didn't bet)
Seat 6: Mr.Skapone (button) folded before Flop (didn't bet)
Seat 7: 1LATESHOW1 (small blind) folded before Flop
Seat 8: malik_msk (big blind) showed [6d Kd] and won (2445) with a straight, Deuce to Six
Seat 9: 2NDclass folded before Flop (didn't bet)



PokerStars Game #69707924257: Tournament #544010396, $20+$2 USD Hold'em No Limit - Level VIII (60/120) - 2011/10/29 21:21:28 MSK [2011/10/29 13:21:28 ET]
Table '544010396 89' 9-max Seat #7 is the button
Seat 2: vikim08 (5226 in chips) 
Seat 3: frankyhh_hh (5477 in chips) 
Seat 4: Lotta<3 (2378 in chips) 
Seat 5: Merceko (4228 in chips) 
Seat 6: Mr.Skapone (5378 in chips) 
Seat 7: 1LATESHOW1 (3471 in chips) 
Seat 8: malik_msk (8803 in chips) 
Seat 9: 2NDclass (2312 in chips) 
vikim08: posts the ante 15
frankyhh_hh: posts the ante 15
Lotta<3: posts the ante 15
Merceko: posts the ante 15
Mr.Skapone: posts the ante 15
1LATESHOW1: posts the ante 15
malik_msk: posts the ante 15
2NDclass: posts the ante 15
malik_msk: posts small blind 60
2NDclass: posts big blind 120
*** HOLE CARDS ***
Dealt to malik_msk [3d 4h]
vikim08: folds 
frankyhh_hh: folds 
Lotta<3: folds 
stumpyn is connected 
Merceko: folds 
Mr.Skapone: raises 180 to 300
1LATESHOW1: folds 
malik_msk: folds 
2NDclass: calls 180
*** FLOP *** [7h 6s Jh]
2NDclass: checks 
Mr.Skapone: checks 
*** TURN *** [7h 6s Jh] [Ac]
2NDclass: checks 
Mr.Skapone: checks 
*** RIVER *** [7h 6s Jh Ac] [9c]
2NDclass: bets 460
Mr.Skapone: folds 
Uncalled bet (460) returned to 2NDclass
2NDclass collected 780 from pot
2NDclass: doesn't show hand 
*** SUMMARY ***
Total pot 780 | Rake 0 
Board [7h 6s Jh Ac 9c]
Seat 2: vikim08 folded before Flop (didn't bet)
Seat 3: frankyhh_hh folded before Flop (didn't bet)
Seat 4: Lotta<3 folded before Flop (didn't bet)
Seat 5: Merceko folded before Flop (didn't bet)
Seat 6: Mr.Skapone folded on the River
Seat 7: 1LATESHOW1 (button) folded before Flop (didn't bet)
Seat 8: malik_msk (small blind) folded before Flop
Seat 9: 2NDclass (big blind) collected (780)



PokerStars Game #69707972499: Tournament #544010396, $20+$2 USD Hold'em No Limit - Level VIII (60/120) - 2011/10/29 21:22:24 MSK [2011/10/29 13:22:24 ET]
Table '544010396 89' 9-max Seat #8 is the button
Seat 1: stumpyn (2180 in chips) 
Seat 2: vikim08 (5211 in chips) 
Seat 3: frankyhh_hh (5462 in chips) 
Seat 4: Lotta<3 (2363 in chips) 
Seat 5: Merceko (4213 in chips) 
Seat 6: Mr.Skapone (5063 in chips) 
Seat 7: 1LATESHOW1 (3456 in chips) 
Seat 8: malik_msk (8728 in chips) 
Seat 9: 2NDclass (2777 in chips) 
stumpyn: posts the ante 15
vikim08: posts the ante 15
frankyhh_hh: posts the ante 15
Lotta<3: posts the ante 15
Merceko: posts the ante 15
Mr.Skapone: posts the ante 15
1LATESHOW1: posts the ante 15
malik_msk: posts the ante 15
2NDclass: posts the ante 15
2NDclass: posts small blind 60
stumpyn: posts big blind 120
*** HOLE CARDS ***
Dealt to malik_msk [Th 3c]
vikim08: folds 
frankyhh_hh: folds 
Lotta<3: folds 
Merceko: folds 
Mr.Skapone: folds 
1LATESHOW1: folds 
malik_msk: folds 
2NDclass: folds 
Uncalled bet (60) returned to stumpyn
stumpyn collected 255 from pot
*** SUMMARY ***
Total pot 255 | Rake 0 
Seat 1: stumpyn (big blind) collected (255)
Seat 2: vikim08 folded before Flop (didn't bet)
Seat 3: frankyhh_hh folded before Flop (didn't bet)
Seat 4: Lotta<3 folded before Flop (didn't bet)
Seat 5: Merceko folded before Flop (didn't bet)
Seat 6: Mr.Skapone folded before Flop (didn't bet)
Seat 7: 1LATESHOW1 folded before Flop (didn't bet)
Seat 8: malik_msk (button) folded before Flop (didn't bet)
Seat 9: 2NDclass (small blind) folded before Flop



PokerStars Game #69707983451: Tournament #544010396, $20+$2 USD Hold'em No Limit - Level VIII (60/120) - 2011/10/29 21:22:37 MSK [2011/10/29 13:22:37 ET]
Table '544010396 89' 9-max Seat #9 is the button
Seat 1: stumpyn (2360 in chips) 
Seat 2: vikim08 (5196 in chips) 
Seat 3: frankyhh_hh (5447 in chips) 
Seat 4: Lotta<3 (2348 in chips) 
Seat 5: Merceko (4198 in chips) 
Seat 6: Mr.Skapone (5048 in chips) 
Seat 7: 1LATESHOW1 (3441 in chips) 
Seat 8: malik_msk (8713 in chips) 
Seat 9: 2NDclass (2702 in chips) 
stumpyn: posts the ante 15
vikim08: posts the ante 15
frankyhh_hh: posts the ante 15
Lotta<3: posts the ante 15
Merceko: posts the ante 15
Mr.Skapone: posts the ante 15
1LATESHOW1: posts the ante 15
malik_msk: posts the ante 15
2NDclass: posts the ante 15
stumpyn: posts small blind 60
vikim08: posts big blind 120
*** HOLE CARDS ***
Dealt to malik_msk [5s 7h]
frankyhh_hh: folds 
Lotta<3: folds 
Merceko: folds 
Mr.Skapone: folds 
1LATESHOW1: folds 
malik_msk: calls 120
2NDclass: folds 
stumpyn: folds 
vikim08: checks 
*** FLOP *** [3h 8s Qh]
vikim08: checks 
malik_msk: checks 
*** TURN *** [3h 8s Qh] [As]
vikim08: checks 
malik_msk: bets 240
vikim08: folds 
Uncalled bet (240) returned to malik_msk
malik_msk collected 435 from pot
malik_msk: doesn't show hand 
*** SUMMARY ***
Total pot 435 | Rake 0 
Board [3h 8s Qh As]
Seat 1: stumpyn (small blind) folded before Flop
Seat 2: vikim08 (big blind) folded on the Turn
Seat 3: frankyhh_hh folded before Flop (didn't bet)
Seat 4: Lotta<3 folded before Flop (didn't bet)
Seat 5: Merceko folded before Flop (didn't bet)
Seat 6: Mr.Skapone folded before Flop (didn't bet)
Seat 7: 1LATESHOW1 folded before Flop (didn't bet)
Seat 8: malik_msk collected (435)
Seat 9: 2NDclass (button) folded before Flop (didn't bet)



PokerStars Game #69708061906: Tournament #544010396, $20+$2 USD Hold'em No Limit - Level VIII (60/120) - 2011/10/29 21:24:10 MSK [2011/10/29 13:24:10 ET]
Table '544010396 89' 9-max Seat #1 is the button
Seat 1: stumpyn (2285 in chips) 
Seat 2: vikim08 (5061 in chips) 
Seat 3: frankyhh_hh (5432 in chips) 
Seat 4: Lotta<3 (2333 in chips) 
Seat 5: Merceko (4183 in chips) 
Seat 6: Mr.Skapone (5033 in chips) 
Seat 7: 1LATESHOW1 (3426 in chips) 
Seat 8: malik_msk (9013 in chips) 
Seat 9: 2NDclass (2687 in chips) 
stumpyn: posts the ante 15
vikim08: posts the ante 15
frankyhh_hh: posts the ante 15
Lotta<3: posts the ante 15
Merceko: posts the ante 15
Mr.Skapone: posts the ante 15
1LATESHOW1: posts the ante 15
malik_msk: posts the ante 15
2NDclass: posts the ante 15
vikim08: posts small blind 60
frankyhh_hh: posts big blind 120
*** HOLE CARDS ***
Dealt to malik_msk [9h Ac]
Lotta<3: folds 
Merceko: folds 
Mr.Skapone: folds 
1LATESHOW1: folds 
malik_msk: calls 120
2NDclass: calls 120
stumpyn: folds 
vikim08: calls 60
frankyhh_hh: checks 
*** FLOP *** [3c Qd 7h]
vikim08: checks 
frankyhh_hh: checks 
malik_msk: checks 
2NDclass: bets 240
vikim08 has timed out
vikim08: folds 
vikim08 is sitting out
frankyhh_hh: folds 
malik_msk: folds 
Uncalled bet (240) returned to 2NDclass
2NDclass collected 615 from pot
2NDclass: doesn't show hand 
*** SUMMARY ***
Total pot 615 | Rake 0 
Board [3c Qd 7h]
Seat 1: stumpyn (button) folded before Flop (didn't bet)
Seat 2: vikim08 (small blind) folded on the Flop
Seat 3: frankyhh_hh (big blind) folded on the Flop
Seat 4: Lotta<3 folded before Flop (didn't bet)
Seat 5: Merceko folded before Flop (didn't bet)
Seat 6: Mr.Skapone folded before Flop (didn't bet)
Seat 7: 1LATESHOW1 folded before Flop (didn't bet)
Seat 8: malik_msk folded on the Flop
Seat 9: 2NDclass collected (615)



PokerStars Game #69708139453: Tournament #544010396, $20+$2 USD Hold'em No Limit - Level VIII (60/120) - 2011/10/29 21:25:42 MSK [2011/10/29 13:25:42 ET]
Table '544010396 89' 9-max Seat #2 is the button
Seat 1: stumpyn (2270 in chips) 
Seat 2: vikim08 (4926 in chips) is sitting out
Seat 3: frankyhh_hh (5297 in chips) 
Seat 4: Lotta<3 (2318 in chips) 
Seat 5: Merceko (4168 in chips) 
Seat 6: Mr.Skapone (5018 in chips) 
Seat 7: 1LATESHOW1 (3411 in chips) 
Seat 8: malik_msk (8878 in chips) 
Seat 9: 2NDclass (3167 in chips) 
stumpyn: posts the ante 15
vikim08: posts the ante 15
frankyhh_hh: posts the ante 15
Lotta<3: posts the ante 15
Merceko: posts the ante 15
Mr.Skapone: posts the ante 15
1LATESHOW1: posts the ante 15
malik_msk: posts the ante 15
2NDclass: posts the ante 15
frankyhh_hh: posts small blind 60
Lotta<3: posts big blind 120
*** HOLE CARDS ***
Dealt to malik_msk [4h 6s]
Merceko: folds 
Mr.Skapone: folds 
1LATESHOW1: folds 
malik_msk: folds 
2NDclass: folds 
stumpyn: folds 
vikim08: folds 
frankyhh_hh: folds 
Uncalled bet (60) returned to Lotta<3
Lotta<3 collected 255 from pot
Lotta<3: doesn't show hand 
vikim08 has returned
*** SUMMARY ***
Total pot 255 | Rake 0 
Seat 1: stumpyn folded before Flop (didn't bet)
Seat 2: vikim08 (button) folded before Flop (didn't bet)
Seat 3: frankyhh_hh (small blind) folded before Flop
Seat 4: Lotta<3 (big blind) collected (255)
Seat 5: Merceko folded before Flop (didn't bet)
Seat 6: Mr.Skapone folded before Flop (didn't bet)
Seat 7: 1LATESHOW1 folded before Flop (didn't bet)
Seat 8: malik_msk folded before Flop (didn't bet)
Seat 9: 2NDclass folded before Flop (didn't bet)



PokerStars Game #69708151718: Tournament #544010396, $20+$2 USD Hold'em No Limit - Level VIII (60/120) - 2011/10/29 21:25:56 MSK [2011/10/29 13:25:56 ET]
Table '544010396 89' 9-max Seat #3 is the button
Seat 1: stumpyn (2255 in chips) 
Seat 2: vikim08 (4911 in chips) 
Seat 3: frankyhh_hh (5222 in chips) 
Seat 4: Lotta<3 (2498 in chips) 
Seat 5: Merceko (4153 in chips) 
Seat 6: Mr.Skapone (5003 in chips) 
Seat 7: 1LATESHOW1 (3396 in chips) 
Seat 8: malik_msk (8863 in chips) 
Seat 9: 2NDclass (3152 in chips) 
stumpyn: posts the ante 15
vikim08: posts the ante 15
frankyhh_hh: posts the ante 15
Lotta<3: posts the ante 15
Merceko: posts the ante 15
Mr.Skapone: posts the ante 15
1LATESHOW1: posts the ante 15
malik_msk: posts the ante 15
2NDclass: posts the ante 15
Lotta<3: posts small blind 60
Merceko: posts big blind 120
*** HOLE CARDS ***
Dealt to malik_msk [9h 8d]
Mr.Skapone: folds 
1LATESHOW1: folds 
malik_msk: calls 120
2NDclass: folds 
stumpyn: folds 
vikim08 has timed out
vikim08: folds 
vikim08 is sitting out
frankyhh_hh: folds 
vikim08 has returned
Lotta<3: raises 370 to 490
Merceko: folds 
malik_msk: calls 370
*** FLOP *** [Qs 3h 6h]
Lotta<3: bets 600
malik_msk: folds 
Uncalled bet (600) returned to Lotta<3
Lotta<3 collected 1235 from pot
Lotta<3: doesn't show hand 
*** SUMMARY ***
Total pot 1235 | Rake 0 
Board [Qs 3h 6h]
Seat 1: stumpyn folded before Flop (didn't bet)
Seat 2: vikim08 folded before Flop (didn't bet)
Seat 3: frankyhh_hh (button) folded before Flop (didn't bet)
Seat 4: Lotta<3 (small blind) collected (1235)
Seat 5: Merceko (big blind) folded before Flop
Seat 6: Mr.Skapone folded before Flop (didn't bet)
Seat 7: 1LATESHOW1 folded before Flop (didn't bet)
Seat 8: malik_msk folded on the Flop
Seat 9: 2NDclass folded before Flop (didn't bet)



PokerStars Game #69708214781: Tournament #544010396, $20+$2 USD Hold'em No Limit - Level VIII (60/120) - 2011/10/29 21:27:10 MSK [2011/10/29 13:27:10 ET]
Table '544010396 89' 9-max Seat #4 is the button
Seat 1: stumpyn (2240 in chips) 
Seat 2: vikim08 (4896 in chips) 
Seat 3: frankyhh_hh (5207 in chips) 
Seat 4: Lotta<3 (3228 in chips) 
Seat 5: Merceko (4018 in chips) 
Seat 6: Mr.Skapone (4988 in chips) 
Seat 7: 1LATESHOW1 (3381 in chips) 
Seat 8: malik_msk (8358 in chips) 
Seat 9: 2NDclass (3137 in chips) 
stumpyn: posts the ante 15
vikim08: posts the ante 15
frankyhh_hh: posts the ante 15
Lotta<3: posts the ante 15
Merceko: posts the ante 15
Mr.Skapone: posts the ante 15
1LATESHOW1: posts the ante 15
malik_msk: posts the ante 15
2NDclass: posts the ante 15
Merceko: posts small blind 60
Mr.Skapone: posts big blind 120
*** HOLE CARDS ***
Dealt to malik_msk [4d 8h]
1LATESHOW1: folds 
malik_msk: folds 
2NDclass: folds 
stumpyn: folds 
vikim08: folds 
frankyhh_hh: folds 
Lotta<3: raises 156 to 276
Merceko: folds 
Mr.Skapone: calls 156
*** FLOP *** [Js 3h Jd]
Mr.Skapone: checks 
Lotta<3: bets 194
Mr.Skapone: raises 406 to 600
Lotta<3: folds 
Uncalled bet (406) returned to Mr.Skapone
Mr.Skapone collected 1135 from pot
*** SUMMARY ***
Total pot 1135 | Rake 0 
Board [Js 3h Jd]
Seat 1: stumpyn folded before Flop (didn't bet)
Seat 2: vikim08 folded before Flop (didn't bet)
Seat 3: frankyhh_hh folded before Flop (didn't bet)
Seat 4: Lotta<3 (button) folded on the Flop
Seat 5: Merceko (small blind) folded before Flop
Seat 6: Mr.Skapone (big blind) collected (1135)
Seat 7: 1LATESHOW1 folded before Flop (didn't bet)
Seat 8: malik_msk folded before Flop (didn't bet)
Seat 9: 2NDclass folded before Flop (didn't bet)



PokerStars Game #69708358878: Tournament #544010396, $20+$2 USD Hold'em No Limit - Level IX (75/150) - 2011/10/29 21:29:59 MSK [2011/10/29 13:29:59 ET]
Table '544010396 89' 9-max Seat #7 is the button
Seat 1: stumpyn (2185 in chips) 
Seat 2: vikim08 (4841 in chips) 
Seat 3: frankyhh_hh (5152 in chips) 
Seat 4: Lotta<3 (2703 in chips) 
Seat 5: Merceko (3903 in chips) 
Seat 6: Mr.Skapone (5928 in chips) 
Seat 7: 1LATESHOW1 (3101 in chips) 
Seat 8: malik_msk (8558 in chips) 
Seat 9: 2NDclass (3082 in chips) 
stumpyn: posts the ante 20
vikim08: posts the ante 20
frankyhh_hh: posts the ante 20
Lotta<3: posts the ante 20
Merceko: posts the ante 20
Mr.Skapone: posts the ante 20
1LATESHOW1: posts the ante 20
malik_msk: posts the ante 20
2NDclass: posts the ante 20
malik_msk: posts small blind 75
2NDclass: posts big blind 150
*** HOLE CARDS ***
Dealt to malik_msk [Qh Kc]
stumpyn: folds 
vikim08: folds 
frankyhh_hh: folds 
Lotta<3: raises 195 to 345
malik_msk is disconnected 
Merceko: folds 
Mr.Skapone: folds 
1LATESHOW1: folds 
malik_msk is connected 
malik_msk: calls 270
2NDclass: folds 
*** FLOP *** [8d Th Qd]
malik_msk: bets 750
Lotta<3: raises 1588 to 2338 and is all-in
malik_msk: calls 1588
*** TURN *** [8d Th Qd] [Kh]
*** RIVER *** [8d Th Qd Kh] [5d]
*** SHOW DOWN ***
malik_msk: shows [Qh Kc] (two pair, Kings and Queens)
Lotta<3: shows [Kd Jd] (a flush, King high)
Lotta<3 collected 5696 from pot
*** SUMMARY ***
Total pot 5696 | Rake 0 
Board [8d Th Qd Kh 5d]
Seat 1: stumpyn folded before Flop (didn't bet)
Seat 2: vikim08 folded before Flop (didn't bet)
Seat 3: frankyhh_hh folded before Flop (didn't bet)
Seat 4: Lotta<3 showed [Kd Jd] and won (5696) with a flush, King high
Seat 5: Merceko folded before Flop (didn't bet)
Seat 6: Mr.Skapone folded before Flop (didn't bet)
Seat 7: 1LATESHOW1 (button) folded before Flop (didn't bet)
Seat 8: malik_msk (small blind) showed [Qh Kc] and lost with two pair, Kings and Queens
Seat 9: 2NDclass (big blind) folded before Flop



PokerStars Game #69708413969: Tournament #544010396, $20+$2 USD Hold'em No Limit - Level IX (75/150) - 2011/10/29 21:31:01 MSK [2011/10/29 13:31:01 ET]
Table '544010396 89' 9-max Seat #8 is the button
Seat 1: stumpyn (2165 in chips) 
Seat 2: vikim08 (4821 in chips) 
Seat 3: frankyhh_hh (5132 in chips) 
Seat 4: Lotta<3 (5696 in chips) 
Seat 5: Merceko (3883 in chips) 
Seat 6: Mr.Skapone (5908 in chips) 
Seat 7: 1LATESHOW1 (3081 in chips) 
Seat 8: malik_msk (5855 in chips) 
Seat 9: 2NDclass (2912 in chips) 
stumpyn: posts the ante 20
vikim08: posts the ante 20
frankyhh_hh: posts the ante 20
Lotta<3: posts the ante 20
Merceko: posts the ante 20
Mr.Skapone: posts the ante 20
1LATESHOW1: posts the ante 20
malik_msk: posts the ante 20
2NDclass: posts the ante 20
2NDclass: posts small blind 75
stumpyn: posts big blind 150
*** HOLE CARDS ***
Dealt to malik_msk [Js 9s]
vikim08: folds 
malik_msk said, "nh"
frankyhh_hh: folds 
Lotta<3: folds 
Merceko: folds 
Mr.Skapone: folds 
Lotta<3 said, "ty, ul"
1LATESHOW1: folds 
malik_msk: calls 150
2NDclass: calls 75
stumpyn: checks 
*** FLOP *** [Qc 6d Td]
2NDclass: checks 
stumpyn: checks 
malik_msk: bets 150
2NDclass: folds 
stumpyn: folds 
Uncalled bet (150) returned to malik_msk
malik_msk collected 630 from pot
malik_msk: doesn't show hand 
*** SUMMARY ***
Total pot 630 | Rake 0 
Board [Qc 6d Td]
Seat 1: stumpyn (big blind) folded on the Flop
Seat 2: vikim08 folded before Flop (didn't bet)
Seat 3: frankyhh_hh folded before Flop (didn't bet)
Seat 4: Lotta<3 folded before Flop (didn't bet)
Seat 5: Merceko folded before Flop (didn't bet)
Seat 6: Mr.Skapone folded before Flop (didn't bet)
Seat 7: 1LATESHOW1 folded before Flop (didn't bet)
Seat 8: malik_msk (button) collected (630)
Seat 9: 2NDclass (small blind) folded on the Flop



PokerStars Game #69708450687: Tournament #544010396, $20+$2 USD Hold'em No Limit - Level IX (75/150) - 2011/10/29 21:31:42 MSK [2011/10/29 13:31:42 ET]
Table '544010396 89' 9-max Seat #9 is the button
Seat 1: stumpyn (1995 in chips) 
Seat 2: vikim08 (4801 in chips) 
Seat 3: frankyhh_hh (5112 in chips) 
Seat 4: Lotta<3 (5676 in chips) 
Seat 5: Merceko (3863 in chips) 
Seat 6: Mr.Skapone (5888 in chips) 
Seat 7: 1LATESHOW1 (3061 in chips) 
Seat 8: malik_msk (6315 in chips) 
Seat 9: 2NDclass (2742 in chips) 
stumpyn: posts the ante 20
vikim08: posts the ante 20
frankyhh_hh: posts the ante 20
Lotta<3: posts the ante 20
Merceko: posts the ante 20
Mr.Skapone: posts the ante 20
1LATESHOW1: posts the ante 20
malik_msk: posts the ante 20
2NDclass: posts the ante 20
stumpyn: posts small blind 75
vikim08: posts big blind 150
*** HOLE CARDS ***
Dealt to malik_msk [Td 8d]
frankyhh_hh: folds 
Lotta<3: folds 
Merceko: folds 
Mr.Skapone: raises 237 to 387
1LATESHOW1: folds 
malik_msk: folds 
2NDclass: folds 
stumpyn: folds 
vikim08: calls 237
*** FLOP *** [Ad 7c Qs]
vikim08: checks 
Mr.Skapone: bets 450
vikim08: folds 
Uncalled bet (450) returned to Mr.Skapone
Mr.Skapone collected 1029 from pot
*** SUMMARY ***
Total pot 1029 | Rake 0 
Board [Ad 7c Qs]
Seat 1: stumpyn (small blind) folded before Flop
Seat 2: vikim08 (big blind) folded on the Flop
Seat 3: frankyhh_hh folded before Flop (didn't bet)
Seat 4: Lotta<3 folded before Flop (didn't bet)
Seat 5: Merceko folded before Flop (didn't bet)
Seat 6: Mr.Skapone collected (1029)
Seat 7: 1LATESHOW1 folded before Flop (didn't bet)
Seat 8: malik_msk folded before Flop (didn't bet)
Seat 9: 2NDclass (button) folded before Flop (didn't bet)



PokerStars Game #69708489072: Tournament #544010396, $20+$2 USD Hold'em No Limit - Level IX (75/150) - 2011/10/29 21:32:25 MSK [2011/10/29 13:32:25 ET]
Table '544010396 89' 9-max Seat #1 is the button
Seat 1: stumpyn (1900 in chips) 
Seat 2: vikim08 (4394 in chips) 
Seat 3: frankyhh_hh (5092 in chips) 
Seat 4: Lotta<3 (5656 in chips) 
Seat 5: Merceko (3843 in chips) 
Seat 6: Mr.Skapone (6510 in chips) 
Seat 7: 1LATESHOW1 (3041 in chips) 
Seat 8: malik_msk (6295 in chips) 
Seat 9: 2NDclass (2722 in chips) 
stumpyn: posts the ante 20
vikim08: posts the ante 20
frankyhh_hh: posts the ante 20
Lotta<3: posts the ante 20
Merceko: posts the ante 20
Mr.Skapone: posts the ante 20
1LATESHOW1: posts the ante 20
malik_msk: posts the ante 20
2NDclass: posts the ante 20
vikim08: posts small blind 75
frankyhh_hh: posts big blind 150
*** HOLE CARDS ***
Dealt to malik_msk [7s 5h]
Lotta<3: folds 
Merceko: folds 
Mr.Skapone: folds 
1LATESHOW1: folds 
malik_msk: folds 
2NDclass: folds 
stumpyn: folds 
vikim08: calls 75
frankyhh_hh: checks 
*** FLOP *** [Js 9d Qh]
vikim08: bets 300
frankyhh_hh: folds 
Uncalled bet (300) returned to vikim08
vikim08 collected 480 from pot
vikim08: shows [Qc]
*** SUMMARY ***
Total pot 480 | Rake 0 
Board [Js 9d Qh]
Seat 1: stumpyn (button) folded before Flop (didn't bet)
Seat 2: vikim08 (small blind) collected (480)
Seat 3: frankyhh_hh (big blind) folded on the Flop
Seat 4: Lotta<3 folded before Flop (didn't bet)
Seat 5: Merceko folded before Flop (didn't bet)
Seat 6: Mr.Skapone folded before Flop (didn't bet)
Seat 7: 1LATESHOW1 folded before Flop (didn't bet)
Seat 8: malik_msk folded before Flop (didn't bet)
Seat 9: 2NDclass folded before Flop (didn't bet)



PokerStars Game #69708554596: Tournament #544010396, $20+$2 USD Hold'em No Limit - Level IX (75/150) - 2011/10/29 21:33:38 MSK [2011/10/29 13:33:38 ET]
Table '544010396 89' 9-max Seat #2 is the button
Seat 1: stumpyn (1880 in chips) 
Seat 2: vikim08 (4704 in chips) 
Seat 3: frankyhh_hh (4922 in chips) 
Seat 4: Lotta<3 (5636 in chips) 
Seat 5: Merceko (3823 in chips) 
Seat 6: Mr.Skapone (6490 in chips) 
Seat 7: 1LATESHOW1 (3021 in chips) 
Seat 8: malik_msk (6275 in chips) 
Seat 9: 2NDclass (2702 in chips) 
stumpyn: posts the ante 20
vikim08: posts the ante 20
frankyhh_hh: posts the ante 20
Lotta<3: posts the ante 20
Merceko: posts the ante 20
Mr.Skapone: posts the ante 20
1LATESHOW1: posts the ante 20
malik_msk: posts the ante 20
2NDclass: posts the ante 20
frankyhh_hh: posts small blind 75
Lotta<3: posts big blind 150
*** HOLE CARDS ***
Dealt to malik_msk [5h Kd]
Merceko: folds 
Mr.Skapone: raises 239 to 389
1LATESHOW1: folds 
malik_msk: folds 
2NDclass: folds 
stumpyn: folds 
vikim08: folds 
frankyhh_hh: folds 
Lotta<3: folds 
Uncalled bet (239) returned to Mr.Skapone
Mr.Skapone collected 555 from pot
*** SUMMARY ***
Total pot 555 | Rake 0 
Seat 1: stumpyn folded before Flop (didn't bet)
Seat 2: vikim08 (button) folded before Flop (didn't bet)
Seat 3: frankyhh_hh (small blind) folded before Flop
Seat 4: Lotta<3 (big blind) folded before Flop
Seat 5: Merceko folded before Flop (didn't bet)
Seat 6: Mr.Skapone collected (555)
Seat 7: 1LATESHOW1 folded before Flop (didn't bet)
Seat 8: malik_msk folded before Flop (didn't bet)
Seat 9: 2NDclass folded before Flop (didn't bet)



PokerStars Game #69708589997: Tournament #544010396, $20+$2 USD Hold'em No Limit - Level IX (75/150) - 2011/10/29 21:34:18 MSK [2011/10/29 13:34:18 ET]
Table '544010396 89' 9-max Seat #3 is the button
Seat 1: stumpyn (1860 in chips) 
Seat 2: vikim08 (4684 in chips) 
Seat 3: frankyhh_hh (4827 in chips) 
Seat 4: Lotta<3 (5466 in chips) 
Seat 5: Merceko (3803 in chips) 
Seat 6: Mr.Skapone (6875 in chips) 
Seat 7: 1LATESHOW1 (3001 in chips) 
Seat 8: malik_msk (6255 in chips) 
Seat 9: 2NDclass (2682 in chips) 
stumpyn: posts the ante 20
vikim08: posts the ante 20
frankyhh_hh: posts the ante 20
Lotta<3: posts the ante 20
Merceko: posts the ante 20
Mr.Skapone: posts the ante 20
1LATESHOW1: posts the ante 20
malik_msk: posts the ante 20
2NDclass: posts the ante 20
Lotta<3: posts small blind 75
Merceko: posts big blind 150
*** HOLE CARDS ***
Dealt to malik_msk [Kh Kd]
Mr.Skapone: folds 
1LATESHOW1: folds 
malik_msk: raises 300 to 450
2NDclass: folds 
stumpyn: folds 
vikim08: folds 
frankyhh_hh: folds 
Lotta<3: folds 
Merceko: folds 
Uncalled bet (300) returned to malik_msk
malik_msk collected 555 from pot
malik_msk: doesn't show hand 
*** SUMMARY ***
Total pot 555 | Rake 0 
Seat 1: stumpyn folded before Flop (didn't bet)
Seat 2: vikim08 folded before Flop (didn't bet)
Seat 3: frankyhh_hh (button) folded before Flop (didn't bet)
Seat 4: Lotta<3 (small blind) folded before Flop
Seat 5: Merceko (big blind) folded before Flop
Seat 6: Mr.Skapone folded before Flop (didn't bet)
Seat 7: 1LATESHOW1 folded before Flop (didn't bet)
Seat 8: malik_msk collected (555)
Seat 9: 2NDclass folded before Flop (didn't bet)



PokerStars Game #69708623329: Tournament #544010396, $20+$2 USD Hold'em No Limit - Level IX (75/150) - 2011/10/29 21:34:56 MSK [2011/10/29 13:34:56 ET]
Table '544010396 89' 9-max Seat #4 is the button
Seat 1: stumpyn (1840 in chips) 
Seat 2: vikim08 (4664 in chips) 
Seat 3: frankyhh_hh (4807 in chips) 
Seat 4: Lotta<3 (5371 in chips) 
Seat 5: Merceko (3633 in chips) 
Seat 6: Mr.Skapone (6855 in chips) 
Seat 7: 1LATESHOW1 (2981 in chips) 
Seat 8: malik_msk (6640 in chips) 
Seat 9: 2NDclass (2662 in chips) 
stumpyn: posts the ante 20
vikim08: posts the ante 20
frankyhh_hh: posts the ante 20
Lotta<3: posts the ante 20
Merceko: posts the ante 20
Mr.Skapone: posts the ante 20
1LATESHOW1: posts the ante 20
malik_msk: posts the ante 20
2NDclass: posts the ante 20
Merceko: posts small blind 75
Mr.Skapone: posts big blind 150
*** HOLE CARDS ***
Dealt to malik_msk [3d 9c]
1LATESHOW1: folds 
malik_msk: folds 
2NDclass: folds 
stumpyn: folds 
vikim08: folds 
frankyhh_hh: raises 225 to 375
Lotta<3: folds 
Merceko: raises 3238 to 3613 and is all-in
Mr.Skapone: folds 
frankyhh_hh: folds 
Uncalled bet (3238) returned to Merceko
Merceko collected 1080 from pot
Merceko: doesn't show hand 
*** SUMMARY ***
Total pot 1080 | Rake 0 
Seat 1: stumpyn folded before Flop (didn't bet)
Seat 2: vikim08 folded before Flop (didn't bet)
Seat 3: frankyhh_hh folded before Flop
Seat 4: Lotta<3 (button) folded before Flop (didn't bet)
Seat 5: Merceko (small blind) collected (1080)
Seat 6: Mr.Skapone (big blind) folded before Flop
Seat 7: 1LATESHOW1 folded before Flop (didn't bet)
Seat 8: malik_msk folded before Flop (didn't bet)
Seat 9: 2NDclass folded before Flop (didn't bet)



PokerStars Game #69708665371: Tournament #544010396, $20+$2 USD Hold'em No Limit - Level IX (75/150) - 2011/10/29 21:35:43 MSK [2011/10/29 13:35:43 ET]
Table '544010396 89' 9-max Seat #5 is the button
Seat 1: stumpyn (1820 in chips) 
Seat 2: vikim08 (4644 in chips) 
Seat 3: frankyhh_hh (4412 in chips) 
Seat 4: Lotta<3 (5351 in chips) 
Seat 5: Merceko (4318 in chips) 
Seat 6: Mr.Skapone (6685 in chips) 
Seat 7: 1LATESHOW1 (2961 in chips) 
Seat 8: malik_msk (6620 in chips) 
Seat 9: 2NDclass (2642 in chips) 
stumpyn: posts the ante 20
vikim08: posts the ante 20
frankyhh_hh: posts the ante 20
Lotta<3: posts the ante 20
Merceko: posts the ante 20
Mr.Skapone: posts the ante 20
1LATESHOW1: posts the ante 20
malik_msk: posts the ante 20
2NDclass: posts the ante 20
Mr.Skapone: posts small blind 75
1LATESHOW1: posts big blind 150
*** HOLE CARDS ***
Dealt to malik_msk [7s 4h]
malik_msk: folds 
2NDclass: folds 
stumpyn: folds 
vikim08: folds 
frankyhh_hh: folds 
Lotta<3: folds 
Merceko: folds 
Mr.Skapone: raises 300 to 450
1LATESHOW1: folds 
Uncalled bet (300) returned to Mr.Skapone
Mr.Skapone collected 480 from pot
*** SUMMARY ***
Total pot 480 | Rake 0 
Seat 1: stumpyn folded before Flop (didn't bet)
Seat 2: vikim08 folded before Flop (didn't bet)
Seat 3: frankyhh_hh folded before Flop (didn't bet)
Seat 4: Lotta<3 folded before Flop (didn't bet)
Seat 5: Merceko (button) folded before Flop (didn't bet)
Seat 6: Mr.Skapone (small blind) collected (480)
Seat 7: 1LATESHOW1 (big blind) folded before Flop
Seat 8: malik_msk folded before Flop (didn't bet)
Seat 9: 2NDclass folded before Flop (didn't bet)



PokerStars Game #69708702238: Tournament #544010396, $20+$2 USD Hold'em No Limit - Level IX (75/150) - 2011/10/29 21:36:25 MSK [2011/10/29 13:36:25 ET]
Table '544010396 89' 9-max Seat #6 is the button
Seat 1: stumpyn (1800 in chips) 
Seat 2: vikim08 (4624 in chips) 
Seat 3: frankyhh_hh (4392 in chips) 
Seat 4: Lotta<3 (5331 in chips) 
Seat 5: Merceko (4298 in chips) 
Seat 6: Mr.Skapone (6995 in chips) 
Seat 7: 1LATESHOW1 (2791 in chips) 
Seat 8: malik_msk (6600 in chips) 
Seat 9: 2NDclass (2622 in chips) 
stumpyn: posts the ante 20
vikim08: posts the ante 20
frankyhh_hh: posts the ante 20
Lotta<3: posts the ante 20
Merceko: posts the ante 20
Mr.Skapone: posts the ante 20
1LATESHOW1: posts the ante 20
malik_msk: posts the ante 20
2NDclass: posts the ante 20
1LATESHOW1: posts small blind 75
malik_msk: posts big blind 150
*** HOLE CARDS ***
Dealt to malik_msk [Tc 9d]
2NDclass: folds 
stumpyn: folds 
vikim08: raises 300 to 450
frankyhh_hh: calls 450
Lotta<3: folds 
Merceko: folds 
Mr.Skapone: folds 
1LATESHOW1: folds 
malik_msk: calls 300
*** FLOP *** [6h 4h 2s]
malik_msk: checks 
vikim08: bets 900
frankyhh_hh: folds 
malik_msk: folds 
Uncalled bet (900) returned to vikim08
vikim08 collected 1605 from pot
*** SUMMARY ***
Total pot 1605 | Rake 0 
Board [6h 4h 2s]
Seat 1: stumpyn folded before Flop (didn't bet)
Seat 2: vikim08 collected (1605)
Seat 3: frankyhh_hh folded on the Flop
Seat 4: Lotta<3 folded before Flop (didn't bet)
Seat 5: Merceko folded before Flop (didn't bet)
Seat 6: Mr.Skapone (button) folded before Flop (didn't bet)
Seat 7: 1LATESHOW1 (small blind) folded before Flop
Seat 8: malik_msk (big blind) folded on the Flop
Seat 9: 2NDclass folded before Flop (didn't bet)



PokerStars Game #69708745999: Tournament #544010396, $20+$2 USD Hold'em No Limit - Level IX (75/150) - 2011/10/29 21:37:14 MSK [2011/10/29 13:37:14 ET]
Table '544010396 89' 9-max Seat #7 is the button
Seat 1: stumpyn (1780 in chips) 
Seat 2: vikim08 (5759 in chips) 
Seat 3: frankyhh_hh (3922 in chips) 
Seat 4: Lotta<3 (5311 in chips) 
Seat 5: Merceko (4278 in chips) 
Seat 6: Mr.Skapone (6975 in chips) 
Seat 7: 1LATESHOW1 (2696 in chips) 
Seat 8: malik_msk (6130 in chips) 
Seat 9: 2NDclass (2602 in chips) 
stumpyn: posts the ante 20
vikim08: posts the ante 20
frankyhh_hh: posts the ante 20
Lotta<3: posts the ante 20
Merceko: posts the ante 20
Mr.Skapone: posts the ante 20
1LATESHOW1: posts the ante 20
malik_msk: posts the ante 20
2NDclass: posts the ante 20
malik_msk: posts small blind 75
2NDclass: posts big blind 150
*** HOLE CARDS ***
Dealt to malik_msk [Qh Ks]
stumpyn: folds 
vikim08: calls 150
frankyhh_hh: folds 
Lotta<3: folds 
Merceko: folds 
Mr.Skapone: calls 150
1LATESHOW1: calls 150
malik_msk: calls 75
2NDclass: checks 
*** FLOP *** [2d 6h As]
malik_msk: checks 
2NDclass: checks 
vikim08: checks 
Mr.Skapone: checks 
1LATESHOW1: bets 558
malik_msk: folds 
2NDclass: folds 
vikim08: folds 
Mr.Skapone: folds 
Uncalled bet (558) returned to 1LATESHOW1
1LATESHOW1 collected 930 from pot
*** SUMMARY ***
Total pot 930 | Rake 0 
Board [2d 6h As]
Seat 1: stumpyn folded before Flop (didn't bet)
Seat 2: vikim08 folded on the Flop
Seat 3: frankyhh_hh folded before Flop (didn't bet)
Seat 4: Lotta<3 folded before Flop (didn't bet)
Seat 5: Merceko folded before Flop (didn't bet)
Seat 6: Mr.Skapone folded on the Flop
Seat 7: 1LATESHOW1 (button) collected (930)
Seat 8: malik_msk (small blind) folded on the Flop
Seat 9: 2NDclass (big blind) folded on the Flop



PokerStars Game #69708826928: Tournament #544010396, $20+$2 USD Hold'em No Limit - Level X (100/200) - 2011/10/29 21:38:46 MSK [2011/10/29 13:38:46 ET]
Table '544010396 89' 9-max Seat #8 is the button
Seat 1: stumpyn (1760 in chips) 
Seat 2: vikim08 (5589 in chips) 
Seat 3: frankyhh_hh (3902 in chips) 
Seat 4: Lotta<3 (5291 in chips) 
Seat 5: Merceko (4258 in chips) 
Seat 6: Mr.Skapone (6805 in chips) 
Seat 7: 1LATESHOW1 (3456 in chips) 
Seat 8: malik_msk (5960 in chips) 
Seat 9: 2NDclass (2432 in chips) 
stumpyn: posts the ante 25
vikim08: posts the ante 25
frankyhh_hh: posts the ante 25
Lotta<3: posts the ante 25
Merceko: posts the ante 25
Mr.Skapone: posts the ante 25
1LATESHOW1: posts the ante 25
malik_msk: posts the ante 25
2NDclass: posts the ante 25
2NDclass: posts small blind 100
stumpyn: posts big blind 200
*** HOLE CARDS ***
Dealt to malik_msk [5c Kh]
vikim08: raises 328 to 528
frankyhh_hh: folds 
Lotta<3: folds 
Merceko: folds 
Mr.Skapone: folds 
1LATESHOW1: folds 
malik_msk: folds 
2NDclass: folds 
stumpyn: folds 
Uncalled bet (328) returned to vikim08
vikim08 collected 725 from pot
*** SUMMARY ***
Total pot 725 | Rake 0 
Seat 1: stumpyn (big blind) folded before Flop
Seat 2: vikim08 collected (725)
Seat 3: frankyhh_hh folded before Flop (didn't bet)
Seat 4: Lotta<3 folded before Flop (didn't bet)
Seat 5: Merceko folded before Flop (didn't bet)
Seat 6: Mr.Skapone folded before Flop (didn't bet)
Seat 7: 1LATESHOW1 folded before Flop (didn't bet)
Seat 8: malik_msk (button) folded before Flop (didn't bet)
Seat 9: 2NDclass (small blind) folded before Flop



PokerStars Game #69708844860: Tournament #544010396, $20+$2 USD Hold'em No Limit - Level X (100/200) - 2011/10/29 21:39:06 MSK [2011/10/29 13:39:06 ET]
Table '544010396 89' 9-max Seat #9 is the button
Seat 1: stumpyn (1535 in chips) 
Seat 2: vikim08 (6089 in chips) 
Seat 3: frankyhh_hh (3877 in chips) 
Seat 4: Lotta<3 (5266 in chips) 
Seat 5: Merceko (4233 in chips) 
Seat 6: Mr.Skapone (6780 in chips) 
Seat 7: 1LATESHOW1 (3431 in chips) 
Seat 8: malik_msk (5935 in chips) 
Seat 9: 2NDclass (2307 in chips) 
stumpyn: posts the ante 25
vikim08: posts the ante 25
frankyhh_hh: posts the ante 25
Lotta<3: posts the ante 25
Merceko: posts the ante 25
Mr.Skapone: posts the ante 25
1LATESHOW1: posts the ante 25
malik_msk: posts the ante 25
2NDclass: posts the ante 25
stumpyn: posts small blind 100
vikim08: posts big blind 200
*** HOLE CARDS ***
Dealt to malik_msk [6s Td]
frankyhh_hh: folds 
Lotta<3: folds 
Merceko: folds 
Mr.Skapone: folds 
1LATESHOW1: raises 300 to 500
malik_msk: folds 
2NDclass: folds 
stumpyn: folds 
vikim08: folds 
Uncalled bet (300) returned to 1LATESHOW1
1LATESHOW1 collected 725 from pot
*** SUMMARY ***
Total pot 725 | Rake 0 
Seat 1: stumpyn (small blind) folded before Flop
Seat 2: vikim08 (big blind) folded before Flop
Seat 3: frankyhh_hh folded before Flop (didn't bet)
Seat 4: Lotta<3 folded before Flop (didn't bet)
Seat 5: Merceko folded before Flop (didn't bet)
Seat 6: Mr.Skapone folded before Flop (didn't bet)
Seat 7: 1LATESHOW1 collected (725)
Seat 8: malik_msk folded before Flop (didn't bet)
Seat 9: 2NDclass (button) folded before Flop (didn't bet)



PokerStars Game #69708879426: Tournament #544010396, $20+$2 USD Hold'em No Limit - Level X (100/200) - 2011/10/29 21:39:46 MSK [2011/10/29 13:39:46 ET]
Table '544010396 89' 9-max Seat #1 is the button
Seat 1: stumpyn (1410 in chips) 
Seat 2: vikim08 (5864 in chips) 
Seat 3: frankyhh_hh (3852 in chips) 
Seat 4: Lotta<3 (5241 in chips) 
Seat 5: Merceko (4208 in chips) 
Seat 6: Mr.Skapone (6755 in chips) 
Seat 7: 1LATESHOW1 (3931 in chips) 
Seat 8: malik_msk (5910 in chips) 
Seat 9: 2NDclass (2282 in chips) 
stumpyn: posts the ante 25
vikim08: posts the ante 25
frankyhh_hh: posts the ante 25
Lotta<3: posts the ante 25
Merceko: posts the ante 25
Mr.Skapone: posts the ante 25
1LATESHOW1: posts the ante 25
malik_msk: posts the ante 25
2NDclass: posts the ante 25
vikim08: posts small blind 100
frankyhh_hh: posts big blind 200
*** HOLE CARDS ***
Dealt to malik_msk [5h Ad]
Lotta<3: folds 
Merceko: folds 
Mr.Skapone: folds 
1LATESHOW1: folds 
malik_msk: calls 200
2NDclass: folds 
stumpyn: folds 
vikim08: calls 100
frankyhh_hh: checks 
*** FLOP *** [5d 8s Qd]
vikim08: checks 
frankyhh_hh: bets 200
malik_msk: calls 200
vikim08: calls 200
*** TURN *** [5d 8s Qd] [6d]
vikim08: checks 
frankyhh_hh: bets 400
malik_msk: calls 400
vikim08: folds 
*** RIVER *** [5d 8s Qd 6d] [4h]
frankyhh_hh: bets 800
malik_msk: folds 
Uncalled bet (800) returned to frankyhh_hh
frankyhh_hh collected 2225 from pot
*** SUMMARY ***
Total pot 2225 | Rake 0 
Board [5d 8s Qd 6d 4h]
Seat 1: stumpyn (button) folded before Flop (didn't bet)
Seat 2: vikim08 (small blind) folded on the Turn
Seat 3: frankyhh_hh (big blind) collected (2225)
Seat 4: Lotta<3 folded before Flop (didn't bet)
Seat 5: Merceko folded before Flop (didn't bet)
Seat 6: Mr.Skapone folded before Flop (didn't bet)
Seat 7: 1LATESHOW1 folded before Flop (didn't bet)
Seat 8: malik_msk folded on the River
Seat 9: 2NDclass folded before Flop (didn't bet)



PokerStars Game #69708959598: Tournament #544010396, $20+$2 USD Hold'em No Limit - Level X (100/200) - 2011/10/29 21:41:17 MSK [2011/10/29 13:41:17 ET]
Table '544010396 89' 9-max Seat #2 is the button
Seat 1: stumpyn (1385 in chips) 
Seat 2: vikim08 (5439 in chips) 
Seat 3: frankyhh_hh (5252 in chips) 
Seat 4: Lotta<3 (5216 in chips) 
Seat 5: Merceko (4183 in chips) 
Seat 6: Mr.Skapone (6730 in chips) 
Seat 7: 1LATESHOW1 (3906 in chips) 
Seat 8: malik_msk (5085 in chips) 
Seat 9: 2NDclass (2257 in chips) 
stumpyn: posts the ante 25
vikim08: posts the ante 25
frankyhh_hh: posts the ante 25
Lotta<3: posts the ante 25
Merceko: posts the ante 25
Mr.Skapone: posts the ante 25
1LATESHOW1: posts the ante 25
malik_msk: posts the ante 25
2NDclass: posts the ante 25
frankyhh_hh: posts small blind 100
Lotta<3: posts big blind 200
*** HOLE CARDS ***
Dealt to malik_msk [8c 5d]
Merceko: folds 
Mr.Skapone: folds 
1LATESHOW1: folds 
malik_msk: folds 
2NDclass: folds 
stumpyn: folds 
vikim08: raises 200 to 400
frankyhh_hh: folds 
Lotta<3: folds 
Uncalled bet (200) returned to vikim08
vikim08 collected 725 from pot
*** SUMMARY ***
Total pot 725 | Rake 0 
Seat 1: stumpyn folded before Flop (didn't bet)
Seat 2: vikim08 (button) collected (725)
Seat 3: frankyhh_hh (small blind) folded before Flop
Seat 4: Lotta<3 (big blind) folded before Flop
Seat 5: Merceko folded before Flop (didn't bet)
Seat 6: Mr.Skapone folded before Flop (didn't bet)
Seat 7: 1LATESHOW1 folded before Flop (didn't bet)
Seat 8: malik_msk folded before Flop (didn't bet)
Seat 9: 2NDclass folded before Flop (didn't bet)



PokerStars Game #69708991562: Tournament #544010396, $20+$2 USD Hold'em No Limit - Level X (100/200) - 2011/10/29 21:41:54 MSK [2011/10/29 13:41:54 ET]
Table '544010396 89' 9-max Seat #3 is the button
Seat 1: stumpyn (1360 in chips) 
Seat 2: vikim08 (5939 in chips) 
Seat 3: frankyhh_hh (5127 in chips) 
Seat 4: Lotta<3 (4991 in chips) 
Seat 5: Merceko (4158 in chips) 
Seat 6: Mr.Skapone (6705 in chips) 
Seat 7: 1LATESHOW1 (3881 in chips) 
Seat 8: malik_msk (5060 in chips) 
Seat 9: 2NDclass (2232 in chips) 
stumpyn: posts the ante 25
vikim08: posts the ante 25
frankyhh_hh: posts the ante 25
Lotta<3: posts the ante 25
Merceko: posts the ante 25
Mr.Skapone: posts the ante 25
1LATESHOW1: posts the ante 25
malik_msk: posts the ante 25
2NDclass: posts the ante 25
Lotta<3: posts small blind 100
Merceko: posts big blind 200
*** HOLE CARDS ***
Dealt to malik_msk [8d 3c]
Mr.Skapone: folds 
1LATESHOW1: folds 
malik_msk: folds 
2NDclass: raises 259 to 459
stumpyn: folds 
vikim08: folds 
frankyhh_hh: calls 459
Lotta<3: folds 
Merceko: folds 
*** FLOP *** [Td 9d 5c]
2NDclass: checks 
frankyhh_hh: checks 
*** TURN *** [Td 9d 5c] [9h]
2NDclass: bets 1748 and is all-in
frankyhh_hh: folds 
Uncalled bet (1748) returned to 2NDclass
2NDclass collected 1443 from pot
*** SUMMARY ***
Total pot 1443 | Rake 0 
Board [Td 9d 5c 9h]
Seat 1: stumpyn folded before Flop (didn't bet)
Seat 2: vikim08 folded before Flop (didn't bet)
Seat 3: frankyhh_hh (button) folded on the Turn
Seat 4: Lotta<3 (small blind) folded before Flop
Seat 5: Merceko (big blind) folded before Flop
Seat 6: Mr.Skapone folded before Flop (didn't bet)
Seat 7: 1LATESHOW1 folded before Flop (didn't bet)
Seat 8: malik_msk folded before Flop (didn't bet)
Seat 9: 2NDclass collected (1443)



PokerStars Game #69709042999: Tournament #544010396, $20+$2 USD Hold'em No Limit - Level X (100/200) - 2011/10/29 21:42:53 MSK [2011/10/29 13:42:53 ET]
Table '544010396 89' 9-max Seat #4 is the button
Seat 1: stumpyn (1335 in chips) 
Seat 2: vikim08 (5914 in chips) 
Seat 3: frankyhh_hh (4643 in chips) 
Seat 4: Lotta<3 (4866 in chips) 
Seat 5: Merceko (3933 in chips) 
Seat 6: Mr.Skapone (6680 in chips) 
Seat 7: 1LATESHOW1 (3856 in chips) 
Seat 8: malik_msk (5035 in chips) 
Seat 9: 2NDclass (3191 in chips) 
stumpyn: posts the ante 25
vikim08: posts the ante 25
frankyhh_hh: posts the ante 25
Lotta<3: posts the ante 25
Merceko: posts the ante 25
Mr.Skapone: posts the ante 25
1LATESHOW1: posts the ante 25
malik_msk: posts the ante 25
2NDclass: posts the ante 25
Merceko: posts small blind 100
Mr.Skapone: posts big blind 200
*** HOLE CARDS ***
Dealt to malik_msk [Kd 8c]
1LATESHOW1: folds 
malik_msk: folds 
2NDclass: folds 
stumpyn: raises 1110 to 1310 and is all-in
vikim08: folds 
frankyhh_hh: folds 
Lotta<3: folds 
Merceko: folds 
Mr.Skapone: calls 1110
*** FLOP *** [5d 8s 5s]
*** TURN *** [5d 8s 5s] [Td]
*** RIVER *** [5d 8s 5s Td] [4d]
*** SHOW DOWN ***
Mr.Skapone: shows [Js As] (a pair of Fives)
stumpyn: shows [3c 3s] (two pair, Fives and Threes)
stumpyn collected 2945 from pot
*** SUMMARY ***
Total pot 2945 | Rake 0 
Board [5d 8s 5s Td 4d]
Seat 1: stumpyn showed [3c 3s] and won (2945) with two pair, Fives and Threes
Seat 2: vikim08 folded before Flop (didn't bet)
Seat 3: frankyhh_hh folded before Flop (didn't bet)
Seat 4: Lotta<3 (button) folded before Flop (didn't bet)
Seat 5: Merceko (small blind) folded before Flop
Seat 6: Mr.Skapone (big blind) showed [Js As] and lost with a pair of Fives
Seat 7: 1LATESHOW1 folded before Flop (didn't bet)
Seat 8: malik_msk folded before Flop (didn't bet)
Seat 9: 2NDclass folded before Flop (didn't bet)



PokerStars Game #69709102345: Tournament #544010396, $20+$2 USD Hold'em No Limit - Level X (100/200) - 2011/10/29 21:44:00 MSK [2011/10/29 13:44:00 ET]
Table '544010396 89' 9-max Seat #5 is the button
Seat 1: stumpyn (2945 in chips) 
Seat 2: vikim08 (5889 in chips) 
Seat 3: frankyhh_hh (4618 in chips) 
Seat 4: Lotta<3 (4841 in chips) 
Seat 5: Merceko (3808 in chips) 
Seat 6: Mr.Skapone (5345 in chips) 
Seat 7: 1LATESHOW1 (3831 in chips) 
Seat 8: malik_msk (5010 in chips) 
Seat 9: 2NDclass (3166 in chips) 
stumpyn: posts the ante 25
vikim08: posts the ante 25
frankyhh_hh: posts the ante 25
Lotta<3: posts the ante 25
Merceko: posts the ante 25
Mr.Skapone: posts the ante 25
1LATESHOW1: posts the ante 25
malik_msk: posts the ante 25
2NDclass: posts the ante 25
Mr.Skapone: posts small blind 100
1LATESHOW1: posts big blind 200
*** HOLE CARDS ***
Dealt to malik_msk [Td 3d]
malik_msk: calls 200
2NDclass: folds 
stumpyn: folds 
vikim08: folds 
frankyhh_hh: folds 
Lotta<3: folds 
Merceko: folds 
Mr.Skapone: folds 
1LATESHOW1: checks 
*** FLOP *** [Th 9h As]
1LATESHOW1: checks 
malik_msk: bets 400
1LATESHOW1: folds 
Uncalled bet (400) returned to malik_msk
malik_msk collected 725 from pot
malik_msk: doesn't show hand 
*** SUMMARY ***
Total pot 725 | Rake 0 
Board [Th 9h As]
Seat 1: stumpyn folded before Flop (didn't bet)
Seat 2: vikim08 folded before Flop (didn't bet)
Seat 3: frankyhh_hh folded before Flop (didn't bet)
Seat 4: Lotta<3 folded before Flop (didn't bet)
Seat 5: Merceko (button) folded before Flop (didn't bet)
Seat 6: Mr.Skapone (small blind) folded before Flop
Seat 7: 1LATESHOW1 (big blind) folded on the Flop
Seat 8: malik_msk collected (725)
Seat 9: 2NDclass folded before Flop (didn't bet)



PokerStars Game #69709165279: Tournament #544010396, $20+$2 USD Hold'em No Limit - Level X (100/200) - 2011/10/29 21:45:12 MSK [2011/10/29 13:45:12 ET]
Table '544010396 89' 9-max Seat #6 is the button
Seat 1: stumpyn (2920 in chips) 
Seat 2: vikim08 (5864 in chips) 
Seat 3: frankyhh_hh (4593 in chips) 
Seat 4: Lotta<3 (4816 in chips) 
Seat 5: Merceko (3783 in chips) 
Seat 6: Mr.Skapone (5220 in chips) 
Seat 7: 1LATESHOW1 (3606 in chips) 
Seat 8: malik_msk (5510 in chips) 
Seat 9: 2NDclass (3141 in chips) 
stumpyn: posts the ante 25
vikim08: posts the ante 25
frankyhh_hh: posts the ante 25
Lotta<3: posts the ante 25
Merceko: posts the ante 25
Mr.Skapone: posts the ante 25
1LATESHOW1: posts the ante 25
malik_msk: posts the ante 25
2NDclass: posts the ante 25
1LATESHOW1: posts small blind 100
malik_msk: posts big blind 200
*** HOLE CARDS ***
Dealt to malik_msk [5d Ah]
2NDclass: raises 200 to 400
stumpyn: folds 
vikim08: folds 
frankyhh_hh: raises 800 to 1200
Lotta<3: folds 
Merceko: folds 
Mr.Skapone: folds 
1LATESHOW1: folds 
malik_msk: folds 
2NDclass: folds 
Uncalled bet (800) returned to frankyhh_hh
frankyhh_hh collected 1325 from pot
*** SUMMARY ***
Total pot 1325 | Rake 0 
Seat 1: stumpyn folded before Flop (didn't bet)
Seat 2: vikim08 folded before Flop (didn't bet)
Seat 3: frankyhh_hh collected (1325)
Seat 4: Lotta<3 folded before Flop (didn't bet)
Seat 5: Merceko folded before Flop (didn't bet)
Seat 6: Mr.Skapone (button) folded before Flop (didn't bet)
Seat 7: 1LATESHOW1 (small blind) folded before Flop
Seat 8: malik_msk (big blind) folded before Flop
Seat 9: 2NDclass folded before Flop



PokerStars Game #69709197623: Tournament #544010396, $20+$2 USD Hold'em No Limit - Level X (100/200) - 2011/10/29 21:45:48 MSK [2011/10/29 13:45:48 ET]
Table '544010396 89' 9-max Seat #7 is the button
Seat 1: stumpyn (2895 in chips) 
Seat 2: vikim08 (5839 in chips) 
Seat 3: frankyhh_hh (5493 in chips) 
Seat 4: Lotta<3 (4791 in chips) 
Seat 5: Merceko (3758 in chips) 
Seat 6: Mr.Skapone (5195 in chips) 
Seat 7: 1LATESHOW1 (3481 in chips) 
Seat 8: malik_msk (5285 in chips) 
Seat 9: 2NDclass (2716 in chips) 
stumpyn: posts the ante 25
vikim08: posts the ante 25
frankyhh_hh: posts the ante 25
Lotta<3: posts the ante 25
Merceko: posts the ante 25
Mr.Skapone: posts the ante 25
1LATESHOW1: posts the ante 25
malik_msk: posts the ante 25
2NDclass: posts the ante 25
malik_msk: posts small blind 100
2NDclass: posts big blind 200
*** HOLE CARDS ***
Dealt to malik_msk [2c 4h]
stumpyn: folds 
vikim08: folds 
frankyhh_hh: folds 
Lotta<3: raises 220 to 420
Merceko: folds 
Mr.Skapone: folds 
1LATESHOW1: folds 
malik_msk: folds 
2NDclass: folds 
Uncalled bet (220) returned to Lotta<3
Lotta<3 collected 725 from pot
Lotta<3: doesn't show hand 
*** SUMMARY ***
Total pot 725 | Rake 0 
Seat 1: stumpyn folded before Flop (didn't bet)
Seat 2: vikim08 folded before Flop (didn't bet)
Seat 3: frankyhh_hh folded before Flop (didn't bet)
Seat 4: Lotta<3 collected (725)
Seat 5: Merceko folded before Flop (didn't bet)
Seat 6: Mr.Skapone folded before Flop (didn't bet)
Seat 7: 1LATESHOW1 (button) folded before Flop (didn't bet)
Seat 8: malik_msk (small blind) folded before Flop
Seat 9: 2NDclass (big blind) folded before Flop



PokerStars Game #69709245857: Tournament #544010396, $20+$2 USD Hold'em No Limit - Level X (100/200) - 2011/10/29 21:46:42 MSK [2011/10/29 13:46:42 ET]
Table '544010396 89' 9-max Seat #8 is the button
Seat 1: stumpyn (2870 in chips) 
Seat 2: vikim08 (5814 in chips) 
Seat 3: frankyhh_hh (5468 in chips) 
Seat 4: Lotta<3 (5291 in chips) 
Seat 5: Merceko (3733 in chips) 
Seat 6: Mr.Skapone (5170 in chips) 
Seat 7: 1LATESHOW1 (3456 in chips) 
Seat 8: malik_msk (5160 in chips) 
Seat 9: 2NDclass (2491 in chips) 
stumpyn: posts the ante 25
vikim08: posts the ante 25
frankyhh_hh: posts the ante 25
Lotta<3: posts the ante 25
Merceko: posts the ante 25
Mr.Skapone: posts the ante 25
1LATESHOW1: posts the ante 25
malik_msk: posts the ante 25
2NDclass: posts the ante 25
2NDclass: posts small blind 100
stumpyn: posts big blind 200
*** HOLE CARDS ***
Dealt to malik_msk [7s Qd]
vikim08: folds 
frankyhh_hh: folds 
Lotta<3: folds 
Merceko: folds 
Mr.Skapone: folds 
1LATESHOW1: folds 
malik_msk: folds 
2NDclass: raises 2266 to 2466 and is all-in
stumpyn: folds 
Uncalled bet (2266) returned to 2NDclass
2NDclass collected 625 from pot
*** SUMMARY ***
Total pot 625 | Rake 0 
Seat 1: stumpyn (big blind) folded before Flop
Seat 2: vikim08 folded before Flop (didn't bet)
Seat 3: frankyhh_hh folded before Flop (didn't bet)
Seat 4: Lotta<3 folded before Flop (didn't bet)
Seat 5: Merceko folded before Flop (didn't bet)
Seat 6: Mr.Skapone folded before Flop (didn't bet)
Seat 7: 1LATESHOW1 folded before Flop (didn't bet)
Seat 8: malik_msk (button) folded before Flop (didn't bet)
Seat 9: 2NDclass (small blind) collected (625)



PokerStars Game #69709281278: Tournament #544010396, $20+$2 USD Hold'em No Limit - Level X (100/200) - 2011/10/29 21:47:23 MSK [2011/10/29 13:47:23 ET]
Table '544010396 89' 9-max Seat #9 is the button
Seat 1: stumpyn (2645 in chips) 
Seat 2: vikim08 (5789 in chips) 
Seat 3: frankyhh_hh (5443 in chips) 
Seat 4: Lotta<3 (5266 in chips) 
Seat 5: Merceko (3708 in chips) 
Seat 6: Mr.Skapone (5145 in chips) 
Seat 7: 1LATESHOW1 (3431 in chips) 
Seat 8: malik_msk (5135 in chips) 
Seat 9: 2NDclass (2891 in chips) 
stumpyn: posts the ante 25
vikim08: posts the ante 25
frankyhh_hh: posts the ante 25
Lotta<3: posts the ante 25
Merceko: posts the ante 25
Mr.Skapone: posts the ante 25
1LATESHOW1: posts the ante 25
malik_msk: posts the ante 25
2NDclass: posts the ante 25
stumpyn: posts small blind 100
vikim08: posts big blind 200
*** HOLE CARDS ***
Dealt to malik_msk [Qs 4s]
frankyhh_hh: folds 
Lotta<3 is disconnected 
Lotta<3 is connected 
Lotta<3: folds 
Merceko: folds 
Mr.Skapone: folds 
1LATESHOW1: folds 
malik_msk: calls 200
2NDclass: folds 
stumpyn: calls 100
vikim08: checks 
*** FLOP *** [5s As Th]
stumpyn: checks 
vikim08: checks 
malik_msk: bets 600
stumpyn: folds 
vikim08: calls 600
*** TURN *** [5s As Th] [8s]
vikim08: checks 
malik_msk: bets 1000
vikim08 has timed out
vikim08: folds 
Uncalled bet (1000) returned to malik_msk
vikim08 is sitting out
malik_msk collected 2025 from pot
malik_msk: doesn't show hand 
*** SUMMARY ***
Total pot 2025 | Rake 0 
Board [5s As Th 8s]
Seat 1: stumpyn (small blind) folded on the Flop
Seat 2: vikim08 (big blind) folded on the Turn
Seat 3: frankyhh_hh folded before Flop (didn't bet)
Seat 4: Lotta<3 folded before Flop (didn't bet)
Seat 5: Merceko folded before Flop (didn't bet)
Seat 6: Mr.Skapone folded before Flop (didn't bet)
Seat 7: 1LATESHOW1 folded before Flop (didn't bet)
Seat 8: malik_msk collected (2025)
Seat 9: 2NDclass (button) folded before Flop (didn't bet)



PokerStars Game #69709411015: Tournament #544010396, $20+$2 USD Hold'em No Limit - Level XI (125/250) - 2011/10/29 21:49:50 MSK [2011/10/29 13:49:50 ET]
Table '544010396 89' 9-max Seat #1 is the button
Seat 1: stumpyn (2420 in chips) 
Seat 2: vikim08 (4964 in chips) 
Seat 3: frankyhh_hh (5418 in chips) 
Seat 4: Lotta<3 (5241 in chips) 
Seat 5: Merceko (3683 in chips) 
Seat 6: Mr.Skapone (5120 in chips) 
Seat 7: 1LATESHOW1 (3406 in chips) 
Seat 8: malik_msk (6335 in chips) 
Seat 9: 2NDclass (2866 in chips) 
stumpyn: posts the ante 30
vikim08: posts the ante 30
frankyhh_hh: posts the ante 30
Lotta<3: posts the ante 30
Merceko: posts the ante 30
Mr.Skapone: posts the ante 30
1LATESHOW1: posts the ante 30
malik_msk: posts the ante 30
2NDclass: posts the ante 30
vikim08: posts small blind 125
frankyhh_hh: posts big blind 250
*** HOLE CARDS ***
Dealt to malik_msk [Jd 5s]
Lotta<3: folds 
Merceko: folds 
Mr.Skapone: raises 394 to 644
1LATESHOW1: folds 
malik_msk: folds 
2NDclass: folds 
stumpyn: folds 
vikim08: folds 
frankyhh_hh: calls 394
*** FLOP *** [3d Ts 7c]
frankyhh_hh: checks 
Mr.Skapone: bets 1000
frankyhh_hh: folds 
Uncalled bet (1000) returned to Mr.Skapone
Mr.Skapone collected 1683 from pot
*** SUMMARY ***
Total pot 1683 | Rake 0 
Board [3d Ts 7c]
Seat 1: stumpyn (button) folded before Flop (didn't bet)
Seat 2: vikim08 (small blind) folded before Flop
Seat 3: frankyhh_hh (big blind) folded on the Flop
Seat 4: Lotta<3 folded before Flop (didn't bet)
Seat 5: Merceko folded before Flop (didn't bet)
Seat 6: Mr.Skapone collected (1683)
Seat 7: 1LATESHOW1 folded before Flop (didn't bet)
Seat 8: malik_msk folded before Flop (didn't bet)
Seat 9: 2NDclass folded before Flop (didn't bet)



PokerStars Game #69709443503: Tournament #544010396, $20+$2 USD Hold'em No Limit - Level XI (125/250) - 2011/10/29 21:50:27 MSK [2011/10/29 13:50:27 ET]
Table '544010396 89' 9-max Seat #2 is the button
Seat 1: stumpyn (2390 in chips) 
Seat 2: vikim08 (4809 in chips) 
Seat 3: frankyhh_hh (4744 in chips) 
Seat 4: Lotta<3 (5211 in chips) 
Seat 5: Merceko (3653 in chips) 
Seat 6: Mr.Skapone (6129 in chips) 
Seat 7: 1LATESHOW1 (3376 in chips) 
Seat 8: malik_msk (6305 in chips) 
Seat 9: 2NDclass (2836 in chips) 
stumpyn: posts the ante 30
vikim08: posts the ante 30
frankyhh_hh: posts the ante 30
Lotta<3: posts the ante 30
Merceko: posts the ante 30
Mr.Skapone: posts the ante 30
1LATESHOW1: posts the ante 30
malik_msk: posts the ante 30
2NDclass: posts the ante 30
frankyhh_hh: posts small blind 125
Lotta<3: posts big blind 250
*** HOLE CARDS ***
Dealt to malik_msk [Js 5h]
Merceko: folds 
Mr.Skapone: folds 
1LATESHOW1: raises 250 to 500
malik_msk: folds 
2NDclass: folds 
stumpyn: folds 
vikim08: folds 
frankyhh_hh: folds 
Lotta<3: folds 
Uncalled bet (250) returned to 1LATESHOW1
1LATESHOW1 collected 895 from pot
*** SUMMARY ***
Total pot 895 | Rake 0 
Seat 1: stumpyn folded before Flop (didn't bet)
Seat 2: vikim08 (button) folded before Flop (didn't bet)
Seat 3: frankyhh_hh (small blind) folded before Flop
Seat 4: Lotta<3 (big blind) folded before Flop
Seat 5: Merceko folded before Flop (didn't bet)
Seat 6: Mr.Skapone folded before Flop (didn't bet)
Seat 7: 1LATESHOW1 collected (895)
Seat 8: malik_msk folded before Flop (didn't bet)
Seat 9: 2NDclass folded before Flop (didn't bet)



PokerStars Game #69709506616: Tournament #544010396, $20+$2 USD Hold'em No Limit - Level XI (125/250) - 2011/10/29 21:51:39 MSK [2011/10/29 13:51:39 ET]
Table '544010396 89' 9-max Seat #3 is the button
Seat 1: stumpyn (2360 in chips) 
Seat 2: vikim08 (4779 in chips) 
Seat 3: frankyhh_hh (4589 in chips) 
Seat 4: Lotta<3 (4931 in chips) 
Seat 5: Merceko (3623 in chips) 
Seat 6: Mr.Skapone (6099 in chips) 
Seat 7: 1LATESHOW1 (3991 in chips) 
Seat 8: malik_msk (6275 in chips) 
Seat 9: 2NDclass (2806 in chips) 
stumpyn: posts the ante 30
vikim08: posts the ante 30
frankyhh_hh: posts the ante 30
Lotta<3: posts the ante 30
Merceko: posts the ante 30
Mr.Skapone: posts the ante 30
1LATESHOW1: posts the ante 30
malik_msk: posts the ante 30
2NDclass: posts the ante 30
Lotta<3: posts small blind 125
Merceko: posts big blind 250
*** HOLE CARDS ***
Dealt to malik_msk [2s 5h]
Mr.Skapone: folds 
1LATESHOW1: folds 
malik_msk: folds 
2NDclass: folds 
stumpyn: folds 
vikim08: folds 
frankyhh_hh: folds 
Lotta<3: raises 325 to 575
Merceko: folds 
Uncalled bet (325) returned to Lotta<3
Lotta<3 collected 770 from pot
Lotta<3: doesn't show hand 
*** SUMMARY ***
Total pot 770 | Rake 0 
Seat 1: stumpyn folded before Flop (didn't bet)
Seat 2: vikim08 folded before Flop (didn't bet)
Seat 3: frankyhh_hh (button) folded before Flop (didn't bet)
Seat 4: Lotta<3 (small blind) collected (770)
Seat 5: Merceko (big blind) folded before Flop
Seat 6: Mr.Skapone folded before Flop (didn't bet)
Seat 7: 1LATESHOW1 folded before Flop (didn't bet)
Seat 8: malik_msk folded before Flop (didn't bet)
Seat 9: 2NDclass folded before Flop (didn't bet)



PokerStars Game #69709530247: Tournament #544010396, $20+$2 USD Hold'em No Limit - Level XI (125/250) - 2011/10/29 21:52:06 MSK [2011/10/29 13:52:06 ET]
Table '544010396 89' 9-max Seat #4 is the button
Seat 1: stumpyn (2330 in chips) 
Seat 2: vikim08 (4749 in chips) 
Seat 3: frankyhh_hh (4559 in chips) 
Seat 4: Lotta<3 (5421 in chips) 
Seat 5: Merceko (3343 in chips) 
Seat 6: Mr.Skapone (6069 in chips) 
Seat 7: 1LATESHOW1 (3961 in chips) 
Seat 8: malik_msk (6245 in chips) 
Seat 9: 2NDclass (2776 in chips) 
stumpyn: posts the ante 30
vikim08: posts the ante 30
frankyhh_hh: posts the ante 30
Lotta<3: posts the ante 30
Merceko: posts the ante 30
Mr.Skapone: posts the ante 30
1LATESHOW1: posts the ante 30
malik_msk: posts the ante 30
2NDclass: posts the ante 30
Merceko: posts small blind 125
Mr.Skapone: posts big blind 250
*** HOLE CARDS ***
Dealt to malik_msk [5s Kc]
1LATESHOW1: folds 
malik_msk: folds 
2NDclass: folds 
stumpyn: raises 375 to 625
vikim08: folds 
frankyhh_hh: calls 625
Lotta<3: folds 
Merceko: folds 
Mr.Skapone: folds 
*** FLOP *** [Js 9c 9s]
stumpyn: bets 500
frankyhh_hh: calls 500
*** TURN *** [Js 9c 9s] [7c]
stumpyn: bets 1175 and is all-in
frankyhh_hh: calls 1175
*** RIVER *** [Js 9c 9s 7c] [2c]
*** SHOW DOWN ***
stumpyn: shows [Tc Td] (two pair, Tens and Nines)
frankyhh_hh: shows [5d 5c] (two pair, Nines and Fives)
stumpyn collected 5245 from pot
*** SUMMARY ***
Total pot 5245 | Rake 0 
Board [Js 9c 9s 7c 2c]
Seat 1: stumpyn showed [Tc Td] and won (5245) with two pair, Tens and Nines
Seat 2: vikim08 folded before Flop (didn't bet)
Seat 3: frankyhh_hh showed [5d 5c] and lost with two pair, Nines and Fives
Seat 4: Lotta<3 (button) folded before Flop (didn't bet)
Seat 5: Merceko (small blind) folded before Flop
Seat 6: Mr.Skapone (big blind) folded before Flop
Seat 7: 1LATESHOW1 folded before Flop (didn't bet)
Seat 8: malik_msk folded before Flop (didn't bet)
Seat 9: 2NDclass folded before Flop (didn't bet)



PokerStars Game #69709577209: Tournament #544010396, $20+$2 USD Hold'em No Limit - Level XI (125/250) - 2011/10/29 21:53:00 MSK [2011/10/29 13:53:00 ET]
Table '544010396 89' 9-max Seat #5 is the button
Seat 1: stumpyn (5245 in chips) 
Seat 2: vikim08 (4719 in chips) 
Seat 3: frankyhh_hh (2229 in chips) 
Seat 4: Lotta<3 (5391 in chips) 
Seat 5: Merceko (3188 in chips) 
Seat 6: Mr.Skapone (5789 in chips) 
Seat 7: 1LATESHOW1 (3931 in chips) 
Seat 8: malik_msk (6215 in chips) 
Seat 9: 2NDclass (2746 in chips) 
stumpyn: posts the ante 30
vikim08: posts the ante 30
frankyhh_hh: posts the ante 30
Lotta<3: posts the ante 30
Merceko: posts the ante 30
Mr.Skapone: posts the ante 30
1LATESHOW1: posts the ante 30
malik_msk: posts the ante 30
2NDclass: posts the ante 30
Mr.Skapone: posts small blind 125
1LATESHOW1: posts big blind 250
*** HOLE CARDS ***
Dealt to malik_msk [5d Kc]
malik_msk: folds 
2NDclass: folds 
stumpyn: folds 
vikim08: folds 
frankyhh_hh: raises 1949 to 2199 and is all-in
Lotta<3: folds 
Merceko: raises 959 to 3158 and is all-in
Mr.Skapone: folds 
1LATESHOW1: folds 
Uncalled bet (959) returned to Merceko
*** FLOP *** [8c Ah Th]
*** TURN *** [8c Ah Th] [Js]
*** RIVER *** [8c Ah Th Js] [3c]
*** SHOW DOWN ***
frankyhh_hh: shows [Qc Ks] (a straight, Ten to Ace)
Merceko: shows [5s 5c] (a pair of Fives)
frankyhh_hh collected 5043 from pot
*** SUMMARY ***
Total pot 5043 | Rake 0 
Board [8c Ah Th Js 3c]
Seat 1: stumpyn folded before Flop (didn't bet)
Seat 2: vikim08 folded before Flop (didn't bet)
Seat 3: frankyhh_hh showed [Qc Ks] and won (5043) with a straight, Ten to Ace
Seat 4: Lotta<3 folded before Flop (didn't bet)
Seat 5: Merceko (button) showed [5s 5c] and lost with a pair of Fives
Seat 6: Mr.Skapone (small blind) folded before Flop
Seat 7: 1LATESHOW1 (big blind) folded before Flop
Seat 8: malik_msk folded before Flop (didn't bet)
Seat 9: 2NDclass folded before Flop (didn't bet)



PokerStars Game #69709615282: Tournament #544010396, $20+$2 USD Hold'em No Limit - Level XI (125/250) - 2011/10/29 21:53:44 MSK [2011/10/29 13:53:44 ET]
Table '544010396 89' 9-max Seat #6 is the button
Seat 1: stumpyn (5215 in chips) 
Seat 2: vikim08 (4689 in chips) 
Seat 3: frankyhh_hh (5043 in chips) 
Seat 4: Lotta<3 (5361 in chips) 
Seat 5: Merceko (959 in chips) 
Seat 6: Mr.Skapone (5634 in chips) 
Seat 7: 1LATESHOW1 (3651 in chips) 
Seat 8: malik_msk (6185 in chips) 
Seat 9: 2NDclass (2716 in chips) 
stumpyn: posts the ante 30
vikim08: posts the ante 30
frankyhh_hh: posts the ante 30
Lotta<3: posts the ante 30
Merceko: posts the ante 30
Mr.Skapone: posts the ante 30
1LATESHOW1: posts the ante 30
malik_msk: posts the ante 30
2NDclass: posts the ante 30
1LATESHOW1: posts small blind 125
malik_msk: posts big blind 250
*** HOLE CARDS ***
Dealt to malik_msk [2d 5s]
2NDclass: folds 
stumpyn: folds 
vikim08: folds 
frankyhh_hh: folds 
Lotta<3: folds 
Merceko: folds 
Mr.Skapone: folds 
1LATESHOW1: raises 375 to 625
malik_msk: calls 375
*** FLOP *** [3c 8s Ah]
1LATESHOW1: bets 1000
malik_msk: raises 4530 to 5530 and is all-in
1LATESHOW1: folds 
Uncalled bet (4530) returned to malik_msk
malik_msk collected 3520 from pot
malik_msk: doesn't show hand 
*** SUMMARY ***
Total pot 3520 | Rake 0 
Board [3c 8s Ah]
Seat 1: stumpyn folded before Flop (didn't bet)
Seat 2: vikim08 folded before Flop (didn't bet)
Seat 3: frankyhh_hh folded before Flop (didn't bet)
Seat 4: Lotta<3 folded before Flop (didn't bet)
Seat 5: Merceko folded before Flop (didn't bet)
Seat 6: Mr.Skapone (button) folded before Flop (didn't bet)
Seat 7: 1LATESHOW1 (small blind) folded on the Flop
Seat 8: malik_msk (big blind) collected (3520)
Seat 9: 2NDclass folded before Flop (didn't bet)



PokerStars Game #69709651175: Tournament #544010396, $20+$2 USD Hold'em No Limit - Level XI (125/250) - 2011/10/29 21:54:25 MSK [2011/10/29 13:54:25 ET]
Table '544010396 89' 9-max Seat #7 is the button
Seat 1: stumpyn (5185 in chips) 
Seat 2: vikim08 (4659 in chips) 
Seat 3: frankyhh_hh (5013 in chips) 
Seat 4: Lotta<3 (5331 in chips) 
Seat 5: Merceko (929 in chips) 
Seat 6: Mr.Skapone (5604 in chips) 
Seat 7: 1LATESHOW1 (1996 in chips) 
Seat 8: malik_msk (8050 in chips) 
Seat 9: 2NDclass (2686 in chips) 
stumpyn: posts the ante 30
vikim08: posts the ante 30
frankyhh_hh: posts the ante 30
Lotta<3: posts the ante 30
Merceko: posts the ante 30
Mr.Skapone: posts the ante 30
1LATESHOW1: posts the ante 30
malik_msk: posts the ante 30
2NDclass: posts the ante 30
malik_msk: posts small blind 125
2NDclass: posts big blind 250
*** HOLE CARDS ***
Dealt to malik_msk [3h 2s]
stumpyn: raises 375 to 625
vikim08: folds 
frankyhh_hh: folds 
Lotta<3: folds 
Merceko: folds 
Mr.Skapone: folds 
1LATESHOW1: folds 
malik_msk: folds 
2NDclass: folds 
Uncalled bet (375) returned to stumpyn
stumpyn collected 895 from pot
*** SUMMARY ***
Total pot 895 | Rake 0 
Seat 1: stumpyn collected (895)
Seat 2: vikim08 folded before Flop (didn't bet)
Seat 3: frankyhh_hh folded before Flop (didn't bet)
Seat 4: Lotta<3 folded before Flop (didn't bet)
Seat 5: Merceko folded before Flop (didn't bet)
Seat 6: Mr.Skapone folded before Flop (didn't bet)
Seat 7: 1LATESHOW1 (button) folded before Flop (didn't bet)
Seat 8: malik_msk (small blind) folded before Flop
Seat 9: 2NDclass (big blind) folded before Flop



PokerStars Game #69709674700: Tournament #544010396, $20+$2 USD Hold'em No Limit - Level XI (125/250) - 2011/10/29 21:54:53 MSK [2011/10/29 13:54:53 ET]
Table '544010396 89' 9-max Seat #8 is the button
Seat 1: stumpyn (5800 in chips) 
Seat 2: vikim08 (4629 in chips) 
Seat 3: frankyhh_hh (4983 in chips) 
Seat 4: Lotta<3 (5301 in chips) 
Seat 5: Merceko (899 in chips) 
Seat 6: Mr.Skapone (5574 in chips) 
Seat 7: 1LATESHOW1 (1966 in chips) 
Seat 8: malik_msk (7895 in chips) 
Seat 9: 2NDclass (2406 in chips) 
stumpyn: posts the ante 30
vikim08: posts the ante 30
frankyhh_hh: posts the ante 30
Lotta<3: posts the ante 30
Merceko: posts the ante 30
Mr.Skapone: posts the ante 30
1LATESHOW1: posts the ante 30
malik_msk: posts the ante 30
2NDclass: posts the ante 30
2NDclass: posts small blind 125
stumpyn: posts big blind 250
*** HOLE CARDS ***
Dealt to malik_msk [4h 7s]
vikim08: folds 
frankyhh_hh: raises 500 to 750
Lotta<3: folds 
Merceko: folds 
Mr.Skapone: folds 
1LATESHOW1: folds 
malik_msk: folds 
2NDclass: folds 
stumpyn: folds 
Uncalled bet (500) returned to frankyhh_hh
frankyhh_hh collected 895 from pot
*** SUMMARY ***
Total pot 895 | Rake 0 
Seat 1: stumpyn (big blind) folded before Flop
Seat 2: vikim08 folded before Flop (didn't bet)
Seat 3: frankyhh_hh collected (895)
Seat 4: Lotta<3 folded before Flop (didn't bet)
Seat 5: Merceko folded before Flop (didn't bet)
Seat 6: Mr.Skapone folded before Flop (didn't bet)
Seat 7: 1LATESHOW1 folded before Flop (didn't bet)
Seat 8: malik_msk (button) folded before Flop (didn't bet)
Seat 9: 2NDclass (small blind) folded before Flop



PokerStars Game #69709956062: Tournament #544010396, $20+$2 USD Hold'em No Limit - Level XI (125/250) - 2011/10/29 22:01:52 MSK [2011/10/29 14:01:52 ET]
Table '544010396 89' 9-max Seat #9 is the button
Seat 1: stumpyn (5520 in chips) 
Seat 2: vikim08 (4599 in chips) 
Seat 3: frankyhh_hh (5598 in chips) 
Seat 4: Lotta<3 (5271 in chips) 
Seat 5: Merceko (869 in chips) 
Seat 6: Mr.Skapone (5544 in chips) 
Seat 7: 1LATESHOW1 (1936 in chips) 
Seat 8: malik_msk (7865 in chips) 
Seat 9: 2NDclass (2251 in chips) 
stumpyn: posts the ante 30
vikim08: posts the ante 30
frankyhh_hh: posts the ante 30
Lotta<3: posts the ante 30
Merceko: posts the ante 30
Mr.Skapone: posts the ante 30
1LATESHOW1: posts the ante 30
malik_msk: posts the ante 30
2NDclass: posts the ante 30
stumpyn: posts small blind 125
vikim08: posts big blind 250
*** HOLE CARDS ***
Dealt to malik_msk [3h 2h]
frankyhh_hh: folds 
Lotta<3 is disconnected 
Lotta<3 has timed out while disconnected
Lotta<3: folds 
Lotta<3 is sitting out
Merceko: folds 
Mr.Skapone: raises 405 to 655
1LATESHOW1: folds 
malik_msk: folds 
2NDclass: folds 
stumpyn: folds 
vikim08: folds 
Uncalled bet (405) returned to Mr.Skapone
Mr.Skapone collected 895 from pot
*** SUMMARY ***
Total pot 895 | Rake 0 
Seat 1: stumpyn (small blind) folded before Flop
Seat 2: vikim08 (big blind) folded before Flop
Seat 3: frankyhh_hh folded before Flop (didn't bet)
Seat 4: Lotta<3 folded before Flop (didn't bet)
Seat 5: Merceko folded before Flop (didn't bet)
Seat 6: Mr.Skapone collected (895)
Seat 7: 1LATESHOW1 folded before Flop (didn't bet)
Seat 8: malik_msk folded before Flop (didn't bet)
Seat 9: 2NDclass (button) folded before Flop (didn't bet)



PokerStars Game #69710040337: Tournament #544010396, $20+$2 USD Hold'em No Limit - Level XI (125/250) - 2011/10/29 22:03:30 MSK [2011/10/29 14:03:30 ET]
Table '544010396 89' 9-max Seat #1 is the button
Seat 1: stumpyn (5365 in chips) 
Seat 2: vikim08 (4319 in chips) 
Seat 3: frankyhh_hh (5568 in chips) 
Seat 4: Lotta<3 (5241 in chips) is sitting out
Seat 5: Merceko (839 in chips) 
Seat 6: Mr.Skapone (6159 in chips) 
Seat 7: 1LATESHOW1 (1906 in chips) 
Seat 8: malik_msk (7835 in chips) 
Seat 9: 2NDclass (2221 in chips) 
stumpyn: posts the ante 30
vikim08: posts the ante 30
frankyhh_hh: posts the ante 30
Lotta<3: posts the ante 30
Merceko: posts the ante 30
Mr.Skapone: posts the ante 30
1LATESHOW1: posts the ante 30
malik_msk: posts the ante 30
2NDclass: posts the ante 30
vikim08: posts small blind 125
frankyhh_hh: posts big blind 250
*** HOLE CARDS ***
Dealt to malik_msk [3d Js]
Lotta<3: folds 
Merceko: raises 559 to 809 and is all-in
Mr.Skapone: folds 
1LATESHOW1: folds 
malik_msk: folds 
Lotta<3 is connected 
Lotta<3 has returned
2NDclass: folds 
stumpyn: raises 559 to 1368
vikim08: folds 
frankyhh_hh: folds 
Uncalled bet (559) returned to stumpyn
*** FLOP *** [Qh Jh 5d]
*** TURN *** [Qh Jh 5d] [8c]
*** RIVER *** [Qh Jh 5d 8c] [Jd]
*** SHOW DOWN ***
Merceko: shows [Ac 6s] (a pair of Jacks)
stumpyn: shows [Ah 8h] (two pair, Jacks and Eights)
stumpyn collected 2263 from pot
Merceko finished the tournament in 1049th place
*** SUMMARY ***
Total pot 2263 | Rake 0 
Board [Qh Jh 5d 8c Jd]
Seat 1: stumpyn (button) showed [Ah 8h] and won (2263) with two pair, Jacks and Eights
Seat 2: vikim08 (small blind) folded before Flop
Seat 3: frankyhh_hh (big blind) folded before Flop
Seat 4: Lotta<3 folded before Flop (didn't bet)
Seat 5: Merceko showed [Ac 6s] and lost with a pair of Jacks
Seat 6: Mr.Skapone folded before Flop (didn't bet)
Seat 7: 1LATESHOW1 folded before Flop (didn't bet)
Seat 8: malik_msk folded before Flop (didn't bet)
Seat 9: 2NDclass folded before Flop (didn't bet)



PokerStars Game #69710076278: Tournament #544010396, $20+$2 USD Hold'em No Limit - Level XI (125/250) - 2011/10/29 22:04:10 MSK [2011/10/29 14:04:10 ET]
Table '544010396 89' 9-max Seat #2 is the button
Seat 1: stumpyn (6789 in chips) 
Seat 2: vikim08 (4164 in chips) 
Seat 3: frankyhh_hh (5288 in chips) 
Seat 4: Lotta<3 (5211 in chips) 
Seat 6: Mr.Skapone (6129 in chips) 
Seat 7: 1LATESHOW1 (1876 in chips) 
Seat 8: malik_msk (7805 in chips) 
Seat 9: 2NDclass (2191 in chips) 
stumpyn: posts the ante 30
vikim08: posts the ante 30
frankyhh_hh: posts the ante 30
Lotta<3: posts the ante 30
Mr.Skapone: posts the ante 30
1LATESHOW1: posts the ante 30
malik_msk: posts the ante 30
2NDclass: posts the ante 30
frankyhh_hh: posts small blind 125
Lotta<3: posts big blind 250
*** HOLE CARDS ***
Dealt to malik_msk [8d As]
Mr.Skapone: folds 
Kjeppen is connected 
1LATESHOW1: folds 
malik_msk: folds 
2NDclass: folds 
stumpyn: folds 
vikim08: raises 250 to 500
frankyhh_hh: calls 375
Lotta<3: folds 
*** FLOP *** [Th 2d 8s]
frankyhh_hh: checks 
vikim08: bets 750
frankyhh_hh: calls 750
*** TURN *** [Th 2d 8s] [Ts]
frankyhh_hh: checks 
vikim08: bets 1000
frankyhh_hh: folds 
Uncalled bet (1000) returned to vikim08
vikim08 collected 2990 from pot
*** SUMMARY ***
Total pot 2990 | Rake 0 
Board [Th 2d 8s Ts]
Seat 1: stumpyn folded before Flop (didn't bet)
Seat 2: vikim08 (button) collected (2990)
Seat 3: frankyhh_hh (small blind) folded on the Turn
Seat 4: Lotta<3 (big blind) folded before Flop
Seat 6: Mr.Skapone folded before Flop (didn't bet)
Seat 7: 1LATESHOW1 folded before Flop (didn't bet)
Seat 8: malik_msk folded before Flop (didn't bet)
Seat 9: 2NDclass folded before Flop (didn't bet)



PokerStars Game #69710150398: Tournament #544010396, $20+$2 USD Hold'em No Limit - Level XII (150/300) - 2011/10/29 22:05:30 MSK [2011/10/29 14:05:30 ET]
Table '544010396 89' 9-max Seat #3 is the button
Seat 1: stumpyn (6759 in chips) 
Seat 2: vikim08 (5874 in chips) 
Seat 3: frankyhh_hh (4008 in chips) 
Seat 4: Lotta<3 (4931 in chips) 
Seat 5: Kjeppen (5058 in chips) 
Seat 6: Mr.Skapone (6099 in chips) 
Seat 7: 1LATESHOW1 (1846 in chips) 
Seat 8: malik_msk (7775 in chips) 
Seat 9: 2NDclass (2161 in chips) 
stumpyn: posts the ante 40
vikim08: posts the ante 40
frankyhh_hh: posts the ante 40
Lotta<3: posts the ante 40
Kjeppen: posts the ante 40
Mr.Skapone: posts the ante 40
1LATESHOW1: posts the ante 40
malik_msk: posts the ante 40
2NDclass: posts the ante 40
Lotta<3: posts small blind 150
Kjeppen: posts big blind 300
*** HOLE CARDS ***
Dealt to malik_msk [4h 4s]
Mr.Skapone: folds 
1LATESHOW1: folds 
malik_msk: raises 600 to 900
2NDclass: folds 
stumpyn: folds 
vikim08: folds 
frankyhh_hh: raises 900 to 1800
Lotta<3: folds 
Kjeppen: folds 
malik_msk: raises 5935 to 7735 and is all-in
frankyhh_hh: calls 2168 and is all-in
Uncalled bet (3767) returned to malik_msk
*** FLOP *** [Kd Ks 3d]
*** TURN *** [Kd Ks 3d] [6h]
*** RIVER *** [Kd Ks 3d 6h] [2s]
*** SHOW DOWN ***
malik_msk: shows [4h 4s] (two pair, Kings and Fours)
frankyhh_hh: shows [Ah Qh] (a pair of Kings)
malik_msk collected 8746 from pot
frankyhh_hh finished the tournament in 1006th place
*** SUMMARY ***
Total pot 8746 | Rake 0 
Board [Kd Ks 3d 6h 2s]
Seat 1: stumpyn folded before Flop (didn't bet)
Seat 2: vikim08 folded before Flop (didn't bet)
Seat 3: frankyhh_hh (button) showed [Ah Qh] and lost with a pair of Kings
Seat 4: Lotta<3 (small blind) folded before Flop
Seat 5: Kjeppen (big blind) folded before Flop
Seat 6: Mr.Skapone folded before Flop (didn't bet)
Seat 7: 1LATESHOW1 folded before Flop (didn't bet)
Seat 8: malik_msk showed [4h 4s] and won (8746) with two pair, Kings and Fours
Seat 9: 2NDclass folded before Flop (didn't bet)



PokerStars Game #69710225228: Tournament #544010396, $20+$2 USD Hold'em No Limit - Level XII (150/300) - 2011/10/29 22:06:50 MSK [2011/10/29 14:06:50 ET]
Table '544010396 89' 9-max Seat #4 is the button
Seat 1: stumpyn (6719 in chips) 
Seat 2: vikim08 (5834 in chips) 
Seat 4: Lotta<3 (4741 in chips) 
Seat 5: Kjeppen (4718 in chips) 
Seat 6: Mr.Skapone (6059 in chips) 
Seat 7: 1LATESHOW1 (1806 in chips) 
Seat 8: malik_msk (12513 in chips) 
Seat 9: 2NDclass (2121 in chips) 
stumpyn: posts the ante 40
vikim08: posts the ante 40
Lotta<3: posts the ante 40
Kjeppen: posts the ante 40
Mr.Skapone: posts the ante 40
1LATESHOW1: posts the ante 40
malik_msk: posts the ante 40
2NDclass: posts the ante 40
Kjeppen: posts small blind 150
Mr.Skapone: posts big blind 300
*** HOLE CARDS ***
Dealt to malik_msk [Jc Th]
1LATESHOW1: folds 
dr.hokiday is connected 
malik_msk: folds 
2NDclass: raises 1781 to 2081 and is all-in
stumpyn: folds 
vikim08: folds 
Lotta<3: folds 
Kjeppen: folds 
Mr.Skapone: folds 
Uncalled bet (1781) returned to 2NDclass
2NDclass collected 1070 from pot
*** SUMMARY ***
Total pot 1070 | Rake 0 
Seat 1: stumpyn folded before Flop (didn't bet)
Seat 2: vikim08 folded before Flop (didn't bet)
Seat 4: Lotta<3 (button) folded before Flop (didn't bet)
Seat 5: Kjeppen (small blind) folded before Flop
Seat 6: Mr.Skapone (big blind) folded before Flop
Seat 7: 1LATESHOW1 folded before Flop (didn't bet)
Seat 8: malik_msk folded before Flop (didn't bet)
Seat 9: 2NDclass collected (1070)



PokerStars Game #69710283326: Tournament #544010396, $20+$2 USD Hold'em No Limit - Level XII (150/300) - 2011/10/29 22:07:52 MSK [2011/10/29 14:07:52 ET]
Table '544010396 89' 9-max Seat #5 is the button
Seat 1: stumpyn (6679 in chips) 
Seat 2: vikim08 (5794 in chips) 
Seat 3: dr.hokiday (6184 in chips) 
Seat 4: Lotta<3 (4701 in chips) 
Seat 5: Kjeppen (4528 in chips) 
Seat 6: Mr.Skapone (5719 in chips) 
Seat 7: 1LATESHOW1 (1766 in chips) 
Seat 8: malik_msk (12473 in chips) 
Seat 9: 2NDclass (2851 in chips) 
stumpyn: posts the ante 40
vikim08: posts the ante 40
dr.hokiday: posts the ante 40
Lotta<3: posts the ante 40
Kjeppen: posts the ante 40
Mr.Skapone: posts the ante 40
1LATESHOW1: posts the ante 40
malik_msk: posts the ante 40
2NDclass: posts the ante 40
Mr.Skapone: posts small blind 150
1LATESHOW1: posts big blind 300
*** HOLE CARDS ***
Dealt to malik_msk [Th 4h]
malik_msk: folds 
2NDclass: folds 
stumpyn: folds 
vikim08: folds 
dr.hokiday: folds 
Lotta<3: folds 
Kjeppen: raises 300 to 600
Mr.Skapone: folds 
1LATESHOW1: raises 1126 to 1726 and is all-in
Kjeppen: calls 1126
*** FLOP *** [2c 2d Ac]
*** TURN *** [2c 2d Ac] [8h]
*** RIVER *** [2c 2d Ac 8h] [9s]
*** SHOW DOWN ***
1LATESHOW1: shows [8s 8c] (a full house, Eights full of Deuces)
Kjeppen: shows [As 4c] (two pair, Aces and Deuces)
1LATESHOW1 collected 3962 from pot
*** SUMMARY ***
Total pot 3962 | Rake 0 
Board [2c 2d Ac 8h 9s]
Seat 1: stumpyn folded before Flop (didn't bet)
Seat 2: vikim08 folded before Flop (didn't bet)
Seat 3: dr.hokiday folded before Flop (didn't bet)
Seat 4: Lotta<3 folded before Flop (didn't bet)
Seat 5: Kjeppen (button) showed [As 4c] and lost with two pair, Aces and Deuces
Seat 6: Mr.Skapone (small blind) folded before Flop
Seat 7: 1LATESHOW1 (big blind) showed [8s 8c] and won (3962) with a full house, Eights full of Deuces
Seat 8: malik_msk folded before Flop (didn't bet)
Seat 9: 2NDclass folded before Flop (didn't bet)



PokerStars Game #69710316422: Tournament #544010396, $20+$2 USD Hold'em No Limit - Level XII (150/300) - 2011/10/29 22:08:27 MSK [2011/10/29 14:08:27 ET]
Table '544010396 89' 9-max Seat #6 is the button
Seat 1: stumpyn (6639 in chips) 
Seat 2: vikim08 (5754 in chips) 
Seat 3: dr.hokiday (6144 in chips) 
Seat 4: Lotta<3 (4661 in chips) 
Seat 5: Kjeppen (2762 in chips) 
Seat 6: Mr.Skapone (5529 in chips) 
Seat 7: 1LATESHOW1 (3962 in chips) 
Seat 8: malik_msk (12433 in chips) 
Seat 9: 2NDclass (2811 in chips) 
stumpyn: posts the ante 40
vikim08: posts the ante 40
dr.hokiday: posts the ante 40
Lotta<3: posts the ante 40
Kjeppen: posts the ante 40
Mr.Skapone: posts the ante 40
1LATESHOW1: posts the ante 40
malik_msk: posts the ante 40
2NDclass: posts the ante 40
1LATESHOW1: posts small blind 150
malik_msk: posts big blind 300
*** HOLE CARDS ***
Dealt to malik_msk [9d 7h]
2NDclass: folds 
stumpyn: folds 
vikim08: folds 
dr.hokiday: folds 
Lotta<3: folds 
Kjeppen: folds 
Mr.Skapone: folds 
1LATESHOW1: folds 
Uncalled bet (150) returned to malik_msk
malik_msk collected 660 from pot
malik_msk: doesn't show hand 
*** SUMMARY ***
Total pot 660 | Rake 0 
Seat 1: stumpyn folded before Flop (didn't bet)
Seat 2: vikim08 folded before Flop (didn't bet)
Seat 3: dr.hokiday folded before Flop (didn't bet)
Seat 4: Lotta<3 folded before Flop (didn't bet)
Seat 5: Kjeppen folded before Flop (didn't bet)
Seat 6: Mr.Skapone (button) folded before Flop (didn't bet)
Seat 7: 1LATESHOW1 (small blind) folded before Flop
Seat 8: malik_msk (big blind) collected (660)
Seat 9: 2NDclass folded before Flop (didn't bet)



PokerStars Game #69710352996: Tournament #544010396, $20+$2 USD Hold'em No Limit - Level XII (150/300) - 2011/10/29 22:09:05 MSK [2011/10/29 14:09:05 ET]
Table '544010396 89' 9-max Seat #7 is the button
Seat 1: stumpyn (6599 in chips) 
Seat 2: vikim08 (5714 in chips) 
Seat 3: dr.hokiday (6104 in chips) 
Seat 4: Lotta<3 (4621 in chips) 
Seat 5: Kjeppen (2722 in chips) 
Seat 6: Mr.Skapone (5489 in chips) 
Seat 7: 1LATESHOW1 (3772 in chips) 
Seat 8: malik_msk (12903 in chips) 
Seat 9: 2NDclass (2771 in chips) 
stumpyn: posts the ante 40
vikim08: posts the ante 40
dr.hokiday: posts the ante 40
Lotta<3: posts the ante 40
Kjeppen: posts the ante 40
Mr.Skapone: posts the ante 40
1LATESHOW1: posts the ante 40
malik_msk: posts the ante 40
2NDclass: posts the ante 40
malik_msk: posts small blind 150
2NDclass: posts big blind 300
*** HOLE CARDS ***
Dealt to malik_msk [4s 5s]
stumpyn: folds 
vikim08: folds 
dr.hokiday: raises 600 to 900
Lotta<3: folds 
Kjeppen: folds 
Mr.Skapone: folds 
1LATESHOW1: folds 
malik_msk: folds 
2NDclass: folds 
Uncalled bet (600) returned to dr.hokiday
dr.hokiday collected 1110 from pot
*** SUMMARY ***
Total pot 1110 | Rake 0 
Seat 1: stumpyn folded before Flop (didn't bet)
Seat 2: vikim08 folded before Flop (didn't bet)
Seat 3: dr.hokiday collected (1110)
Seat 4: Lotta<3 folded before Flop (didn't bet)
Seat 5: Kjeppen folded before Flop (didn't bet)
Seat 6: Mr.Skapone folded before Flop (didn't bet)
Seat 7: 1LATESHOW1 (button) folded before Flop (didn't bet)
Seat 8: malik_msk (small blind) folded before Flop
Seat 9: 2NDclass (big blind) folded before Flop



PokerStars Game #69710395459: Tournament #544010396, $20+$2 USD Hold'em No Limit - Level XII (150/300) - 2011/10/29 22:09:50 MSK [2011/10/29 14:09:50 ET]
Table '544010396 89' 9-max Seat #8 is the button
Seat 1: stumpyn (6559 in chips) 
Seat 2: vikim08 (5674 in chips) 
Seat 3: dr.hokiday (6874 in chips) 
Seat 4: Lotta<3 (4581 in chips) 
Seat 5: Kjeppen (2682 in chips) 
Seat 6: Mr.Skapone (5449 in chips) 
Seat 7: 1LATESHOW1 (3732 in chips) 
Seat 8: malik_msk (12713 in chips) 
Seat 9: 2NDclass (2431 in chips) 
stumpyn: posts the ante 40
vikim08: posts the ante 40
dr.hokiday: posts the ante 40
Lotta<3: posts the ante 40
Kjeppen: posts the ante 40
Mr.Skapone: posts the ante 40
1LATESHOW1: posts the ante 40
malik_msk: posts the ante 40
2NDclass: posts the ante 40
2NDclass: posts small blind 150
stumpyn: posts big blind 300
*** HOLE CARDS ***
Dealt to malik_msk [Kh Qc]
vikim08: folds 
dr.hokiday: folds 
Lotta<3: folds 
Kjeppen: folds 
Mr.Skapone: folds 
1LATESHOW1: folds 
malik_msk: raises 700 to 1000
2NDclass: folds 
stumpyn: folds 
Uncalled bet (700) returned to malik_msk
malik_msk collected 1110 from pot
malik_msk: doesn't show hand 
*** SUMMARY ***
Total pot 1110 | Rake 0 
Seat 1: stumpyn (big blind) folded before Flop
Seat 2: vikim08 folded before Flop (didn't bet)
Seat 3: dr.hokiday folded before Flop (didn't bet)
Seat 4: Lotta<3 folded before Flop (didn't bet)
Seat 5: Kjeppen folded before Flop (didn't bet)
Seat 6: Mr.Skapone folded before Flop (didn't bet)
Seat 7: 1LATESHOW1 folded before Flop (didn't bet)
Seat 8: malik_msk (button) collected (1110)
Seat 9: 2NDclass (small blind) folded before Flop



PokerStars Game #69710431832: Tournament #544010396, $20+$2 USD Hold'em No Limit - Level XII (150/300) - 2011/10/29 22:10:28 MSK [2011/10/29 14:10:28 ET]
Table '544010396 89' 9-max Seat #9 is the button
Seat 1: stumpyn (6219 in chips) 
Seat 2: vikim08 (5634 in chips) 
Seat 3: dr.hokiday (6834 in chips) 
Seat 4: Lotta<3 (4541 in chips) 
Seat 5: Kjeppen (2642 in chips) 
Seat 6: Mr.Skapone (5409 in chips) 
Seat 7: 1LATESHOW1 (3692 in chips) 
Seat 8: malik_msk (13483 in chips) 
Seat 9: 2NDclass (2241 in chips) 
stumpyn: posts the ante 40
vikim08: posts the ante 40
dr.hokiday: posts the ante 40
Lotta<3: posts the ante 40
Kjeppen: posts the ante 40
Mr.Skapone: posts the ante 40
1LATESHOW1: posts the ante 40
malik_msk: posts the ante 40
2NDclass: posts the ante 40
stumpyn: posts small blind 150
vikim08: posts big blind 300
*** HOLE CARDS ***
Dealt to malik_msk [Jd 7h]
dr.hokiday: folds 
Lotta<3: raises 330 to 630
Kjeppen: raises 1972 to 2602 and is all-in
Mr.Skapone: raises 2767 to 5369 and is all-in
1LATESHOW1: folds 
malik_msk: folds 
2NDclass: folds 
stumpyn: folds 
vikim08: folds 
Lotta<3: folds 
Uncalled bet (2767) returned to Mr.Skapone
*** FLOP *** [4s Ks Td]
*** TURN *** [4s Ks Td] [2d]
*** RIVER *** [4s Ks Td 2d] [7c]
*** SHOW DOWN ***
Kjeppen: shows [Ah Jc] (high card Ace)
Mr.Skapone: shows [Ac Kh] (a pair of Kings)
Mr.Skapone collected 6644 from pot
Kjeppen finished the tournament in 916th place
*** SUMMARY ***
Total pot 6644 | Rake 0 
Board [4s Ks Td 2d 7c]
Seat 1: stumpyn (small blind) folded before Flop
Seat 2: vikim08 (big blind) folded before Flop
Seat 3: dr.hokiday folded before Flop (didn't bet)
Seat 4: Lotta<3 folded before Flop
Seat 5: Kjeppen showed [Ah Jc] and lost with high card Ace
Seat 6: Mr.Skapone showed [Ac Kh] and won (6644) with a pair of Kings
Seat 7: 1LATESHOW1 folded before Flop (didn't bet)
Seat 8: malik_msk folded before Flop (didn't bet)
Seat 9: 2NDclass (button) folded before Flop (didn't bet)



PokerStars Game #69710479854: Tournament #544010396, $20+$2 USD Hold'em No Limit - Level XII (150/300) - 2011/10/29 22:11:19 MSK [2011/10/29 14:11:19 ET]
Table '544010396 89' 9-max Seat #1 is the button
Seat 1: stumpyn (6029 in chips) 
Seat 2: vikim08 (5294 in chips) 
Seat 3: dr.hokiday (6794 in chips) 
Seat 4: Lotta<3 (3871 in chips) 
Seat 6: Mr.Skapone (9411 in chips) 
Seat 7: 1LATESHOW1 (3652 in chips) 
Seat 8: malik_msk (13443 in chips) 
Seat 9: 2NDclass (2201 in chips) 
stumpyn: posts the ante 40
vikim08: posts the ante 40
dr.hokiday: posts the ante 40
Lotta<3: posts the ante 40
Mr.Skapone: posts the ante 40
1LATESHOW1: posts the ante 40
malik_msk: posts the ante 40
2NDclass: posts the ante 40
vikim08: posts small blind 150
dr.hokiday: posts big blind 300
*** HOLE CARDS ***
Dealt to malik_msk [7d 7c]
Lotta<3: folds 
Mr.Skapone: folds 
1LATESHOW1: folds 
You Know No is connected 
malik_msk: raises 700 to 1000
2NDclass: raises 1161 to 2161 and is all-in
stumpyn: folds 
vikim08: folds 
dr.hokiday: folds 
malik_msk: calls 1161
*** FLOP *** [3d 2d 8h]
*** TURN *** [3d 2d 8h] [4c]
*** RIVER *** [3d 2d 8h 4c] [3h]
*** SHOW DOWN ***
malik_msk: shows [7d 7c] (two pair, Sevens and Threes)
2NDclass: shows [Qh Jh] (a pair of Threes)
malik_msk collected 5092 from pot
2NDclass finished the tournament in 905th place
*** SUMMARY ***
Total pot 5092 | Rake 0 
Board [3d 2d 8h 4c 3h]
Seat 1: stumpyn (button) folded before Flop (didn't bet)
Seat 2: vikim08 (small blind) folded before Flop
Seat 3: dr.hokiday (big blind) folded before Flop
Seat 4: Lotta<3 folded before Flop (didn't bet)
Seat 6: Mr.Skapone folded before Flop (didn't bet)
Seat 7: 1LATESHOW1 folded before Flop (didn't bet)
Seat 8: malik_msk showed [7d 7c] and won (5092) with two pair, Sevens and Threes
Seat 9: 2NDclass showed [Qh Jh] and lost with a pair of Threes



PokerStars Game #69710517346: Tournament #544010396, $20+$2 USD Hold'em No Limit - Level XII (150/300) - 2011/10/29 22:11:58 MSK [2011/10/29 14:11:58 ET]
Table '544010396 89' 9-max Seat #2 is the button
Seat 1: stumpyn (5989 in chips) 
Seat 2: vikim08 (5104 in chips) 
Seat 3: dr.hokiday (6454 in chips) 
Seat 4: Lotta<3 (3831 in chips) 
Seat 5: You Know No (8143 in chips) 
Seat 6: Mr.Skapone (9371 in chips) 
Seat 7: 1LATESHOW1 (3612 in chips) 
Seat 8: malik_msk (16334 in chips) 
stumpyn: posts the ante 40
vikim08: posts the ante 40
dr.hokiday: posts the ante 40
Lotta<3: posts the ante 40
You Know No: posts the ante 40
Mr.Skapone: posts the ante 40
1LATESHOW1: posts the ante 40
malik_msk: posts the ante 40
dr.hokiday: posts small blind 150
Lotta<3: posts big blind 300
*** HOLE CARDS ***
Dealt to malik_msk [Th Ac]
You Know No: folds 
Mr.Skapone: raises 355 to 655
natashaluz is connected 
1LATESHOW1: raises 1445 to 2100
malik_msk: folds 
stumpyn: folds 
vikim08: folds 
dr.hokiday: folds 
Lotta<3: folds 
Mr.Skapone: folds 
Uncalled bet (1445) returned to 1LATESHOW1
1LATESHOW1 collected 2080 from pot
*** SUMMARY ***
Total pot 2080 | Rake 0 
Seat 1: stumpyn folded before Flop (didn't bet)
Seat 2: vikim08 (button) folded before Flop (didn't bet)
Seat 3: dr.hokiday (small blind) folded before Flop
Seat 4: Lotta<3 (big blind) folded before Flop
Seat 5: You Know No folded before Flop (didn't bet)
Seat 6: Mr.Skapone folded before Flop
Seat 7: 1LATESHOW1 collected (2080)
Seat 8: malik_msk folded before Flop (didn't bet)



PokerStars Game #69710550427: Tournament #544010396, $20+$2 USD Hold'em No Limit - Level XII (150/300) - 2011/10/29 22:12:33 MSK [2011/10/29 14:12:33 ET]
Table '544010396 89' 9-max Seat #3 is the button
Seat 1: stumpyn (5949 in chips) 
Seat 2: vikim08 (5064 in chips) 
Seat 3: dr.hokiday (6264 in chips) 
Seat 4: Lotta<3 (3491 in chips) 
Seat 5: You Know No (8103 in chips) 
Seat 6: Mr.Skapone (8676 in chips) 
Seat 7: 1LATESHOW1 (4997 in chips) 
Seat 8: malik_msk (16294 in chips) 
Seat 9: natashaluz (6433 in chips) 
stumpyn: posts the ante 40
vikim08: posts the ante 40
dr.hokiday: posts the ante 40
Lotta<3: posts the ante 40
You Know No: posts the ante 40
Mr.Skapone: posts the ante 40
1LATESHOW1: posts the ante 40
malik_msk: posts the ante 40
natashaluz: posts the ante 40
Lotta<3: posts small blind 150
You Know No: posts big blind 300
*** HOLE CARDS ***
Dealt to malik_msk [4d 6s]
Mr.Skapone: calls 300
1LATESHOW1: folds 
malik_msk: folds 
natashaluz: folds 
stumpyn: folds 
vikim08: folds 
dr.hokiday: folds 
Lotta<3: folds 
You Know No: checks 
*** FLOP *** [Ah 3h Th]
You Know No: checks 
Mr.Skapone: bets 555
You Know No: folds 
Uncalled bet (555) returned to Mr.Skapone
Mr.Skapone collected 1110 from pot
*** SUMMARY ***
Total pot 1110 | Rake 0 
Board [Ah 3h Th]
Seat 1: stumpyn folded before Flop (didn't bet)
Seat 2: vikim08 folded before Flop (didn't bet)
Seat 3: dr.hokiday (button) folded before Flop (didn't bet)
Seat 4: Lotta<3 (small blind) folded before Flop
Seat 5: You Know No (big blind) folded on the Flop
Seat 6: Mr.Skapone collected (1110)
Seat 7: 1LATESHOW1 folded before Flop (didn't bet)
Seat 8: malik_msk folded before Flop (didn't bet)
Seat 9: natashaluz folded before Flop (didn't bet)



PokerStars Game #69710597756: Tournament #544010396, $20+$2 USD Hold'em No Limit - Level XII (150/300) - 2011/10/29 22:13:23 MSK [2011/10/29 14:13:23 ET]
Table '544010396 89' 9-max Seat #4 is the button
Seat 1: stumpyn (5909 in chips) 
Seat 2: vikim08 (5024 in chips) 
Seat 3: dr.hokiday (6224 in chips) 
Seat 4: Lotta<3 (3301 in chips) 
Seat 5: You Know No (7763 in chips) 
Seat 6: Mr.Skapone (9446 in chips) 
Seat 7: 1LATESHOW1 (4957 in chips) 
Seat 8: malik_msk (16254 in chips) 
Seat 9: natashaluz (6393 in chips) 
stumpyn: posts the ante 40
vikim08: posts the ante 40
dr.hokiday: posts the ante 40
Lotta<3: posts the ante 40
You Know No: posts the ante 40
Mr.Skapone: posts the ante 40
1LATESHOW1: posts the ante 40
malik_msk: posts the ante 40
natashaluz: posts the ante 40
You Know No: posts small blind 150
Mr.Skapone: posts big blind 300
*** HOLE CARDS ***
Dealt to malik_msk [Kh Qc]
1LATESHOW1: folds 
malik_msk: raises 600 to 900
natashaluz: folds 
stumpyn: folds 
vikim08: folds 
dr.hokiday: folds 
Lotta<3: raises 2361 to 3261 and is all-in
You Know No: folds 
Mr.Skapone: folds 
malik_msk: calls 2361
*** FLOP *** [As 6c Kc]
*** TURN *** [As 6c Kc] [Ad]
*** RIVER *** [As 6c Kc Ad] [7d]
*** SHOW DOWN ***
malik_msk: shows [Kh Qc] (two pair, Aces and Kings)
Lotta<3: shows [Ks Kd] (a full house, Kings full of Aces)
Lotta<3 collected 7332 from pot
*** SUMMARY ***
Total pot 7332 | Rake 0 
Board [As 6c Kc Ad 7d]
Seat 1: stumpyn folded before Flop (didn't bet)
Seat 2: vikim08 folded before Flop (didn't bet)
Seat 3: dr.hokiday folded before Flop (didn't bet)
Seat 4: Lotta<3 (button) showed [Ks Kd] and won (7332) with a full house, Kings full of Aces
Seat 5: You Know No (small blind) folded before Flop
Seat 6: Mr.Skapone (big blind) folded before Flop
Seat 7: 1LATESHOW1 folded before Flop (didn't bet)
Seat 8: malik_msk showed [Kh Qc] and lost with two pair, Aces and Kings
Seat 9: natashaluz folded before Flop (didn't bet)



PokerStars Game #69710658480: Tournament #544010396, $20+$2 USD Hold'em No Limit - Level XIII (200/400) - 2011/10/29 22:14:28 MSK [2011/10/29 14:14:28 ET]
Table '544010396 89' 9-max Seat #5 is the button
Seat 1: stumpyn (5869 in chips) 
Seat 2: vikim08 (4984 in chips) 
Seat 3: dr.hokiday (6184 in chips) 
Seat 4: Lotta<3 (7332 in chips) 
Seat 5: You Know No (7573 in chips) 
Seat 6: Mr.Skapone (9106 in chips) 
Seat 7: 1LATESHOW1 (4917 in chips) 
Seat 8: malik_msk (12953 in chips) 
Seat 9: natashaluz (6353 in chips) 
stumpyn: posts the ante 50
vikim08: posts the ante 50
dr.hokiday: posts the ante 50
Lotta<3: posts the ante 50
You Know No: posts the ante 50
Mr.Skapone: posts the ante 50
1LATESHOW1: posts the ante 50
malik_msk: posts the ante 50
natashaluz: posts the ante 50
Mr.Skapone: posts small blind 200
1LATESHOW1: posts big blind 400
*** HOLE CARDS ***
Dealt to malik_msk [Kc Ad]
malik_msk: raises 800 to 1200
natashaluz: folds 
stumpyn: folds 
vikim08: folds 
dr.hokiday: folds 
Lotta<3: folds 
You Know No: folds 
Mr.Skapone: folds 
1LATESHOW1: folds 
Uncalled bet (800) returned to malik_msk
malik_msk collected 1450 from pot
malik_msk: doesn't show hand 
*** SUMMARY ***
Total pot 1450 | Rake 0 
Seat 1: stumpyn folded before Flop (didn't bet)
Seat 2: vikim08 folded before Flop (didn't bet)
Seat 3: dr.hokiday folded before Flop (didn't bet)
Seat 4: Lotta<3 folded before Flop (didn't bet)
Seat 5: You Know No (button) folded before Flop (didn't bet)
Seat 6: Mr.Skapone (small blind) folded before Flop
Seat 7: 1LATESHOW1 (big blind) folded before Flop
Seat 8: malik_msk collected (1450)
Seat 9: natashaluz folded before Flop (didn't bet)



PokerStars Game #69710691402: Tournament #544010396, $20+$2 USD Hold'em No Limit - Level XIII (200/400) - 2011/10/29 22:15:03 MSK [2011/10/29 14:15:03 ET]
Table '544010396 89' 9-max Seat #6 is the button
Seat 1: stumpyn (5819 in chips) 
Seat 2: vikim08 (4934 in chips) 
Seat 3: dr.hokiday (6134 in chips) 
Seat 4: Lotta<3 (7282 in chips) 
Seat 5: You Know No (7523 in chips) 
Seat 6: Mr.Skapone (8856 in chips) 
Seat 7: 1LATESHOW1 (4467 in chips) 
Seat 8: malik_msk (13953 in chips) 
Seat 9: natashaluz (6303 in chips) 
stumpyn: posts the ante 50
vikim08: posts the ante 50
dr.hokiday: posts the ante 50
Lotta<3: posts the ante 50
You Know No: posts the ante 50
Mr.Skapone: posts the ante 50
1LATESHOW1: posts the ante 50
malik_msk: posts the ante 50
natashaluz: posts the ante 50
1LATESHOW1: posts small blind 200
malik_msk: posts big blind 400
*** HOLE CARDS ***
Dealt to malik_msk [Qd Kh]
natashaluz: folds 
stumpyn: folds 
vikim08: folds 
dr.hokiday: folds 
Lotta<3: folds 
You Know No: folds 
Mr.Skapone: folds 
1LATESHOW1: folds 
Uncalled bet (200) returned to malik_msk
malik_msk collected 850 from pot
malik_msk: doesn't show hand 
*** SUMMARY ***
Total pot 850 | Rake 0 
Seat 1: stumpyn folded before Flop (didn't bet)
Seat 2: vikim08 folded before Flop (didn't bet)
Seat 3: dr.hokiday folded before Flop (didn't bet)
Seat 4: Lotta<3 folded before Flop (didn't bet)
Seat 5: You Know No folded before Flop (didn't bet)
Seat 6: Mr.Skapone (button) folded before Flop (didn't bet)
Seat 7: 1LATESHOW1 (small blind) folded before Flop
Seat 8: malik_msk (big blind) collected (850)
Seat 9: natashaluz folded before Flop (didn't bet)



PokerStars Game #69710716752: Tournament #544010396, $20+$2 USD Hold'em No Limit - Level XIII (200/400) - 2011/10/29 22:15:30 MSK [2011/10/29 14:15:30 ET]
Table '544010396 89' 9-max Seat #7 is the button
Seat 1: stumpyn (5769 in chips) 
Seat 2: vikim08 (4884 in chips) 
Seat 3: dr.hokiday (6084 in chips) 
Seat 4: Lotta<3 (7232 in chips) 
Seat 5: You Know No (7473 in chips) 
Seat 6: Mr.Skapone (8806 in chips) 
Seat 7: 1LATESHOW1 (4217 in chips) 
Seat 8: malik_msk (14553 in chips) 
Seat 9: natashaluz (6253 in chips) 
stumpyn: posts the ante 50
vikim08: posts the ante 50
dr.hokiday: posts the ante 50
Lotta<3: posts the ante 50
You Know No: posts the ante 50
Mr.Skapone: posts the ante 50
1LATESHOW1: posts the ante 50
malik_msk: posts the ante 50
natashaluz: posts the ante 50
malik_msk: posts small blind 200
natashaluz: posts big blind 400
*** HOLE CARDS ***
Dealt to malik_msk [5d Jd]
stumpyn: folds 
vikim08: folds 
dr.hokiday: raises 800 to 1200
Lotta<3: folds 
You Know No: folds 
Mr.Skapone: folds 
1LATESHOW1: folds 
malik_msk: folds 
natashaluz: folds 
Uncalled bet (800) returned to dr.hokiday
dr.hokiday collected 1450 from pot
*** SUMMARY ***
Total pot 1450 | Rake 0 
Seat 1: stumpyn folded before Flop (didn't bet)
Seat 2: vikim08 folded before Flop (didn't bet)
Seat 3: dr.hokiday collected (1450)
Seat 4: Lotta<3 folded before Flop (didn't bet)
Seat 5: You Know No folded before Flop (didn't bet)
Seat 6: Mr.Skapone folded before Flop (didn't bet)
Seat 7: 1LATESHOW1 (button) folded before Flop (didn't bet)
Seat 8: malik_msk (small blind) folded before Flop
Seat 9: natashaluz (big blind) folded before Flop



PokerStars Game #69710761110: Tournament #544010396, $20+$2 USD Hold'em No Limit - Level XIII (200/400) - 2011/10/29 22:16:17 MSK [2011/10/29 14:16:17 ET]
Table '544010396 89' 9-max Seat #8 is the button
Seat 1: stumpyn (5719 in chips) 
Seat 2: vikim08 (4834 in chips) 
Seat 3: dr.hokiday (7084 in chips) 
Seat 4: Lotta<3 (7182 in chips) 
Seat 5: You Know No (7423 in chips) 
Seat 6: Mr.Skapone (8756 in chips) 
Seat 7: 1LATESHOW1 (4167 in chips) 
Seat 8: malik_msk (14303 in chips) 
Seat 9: natashaluz (5803 in chips) 
stumpyn: posts the ante 50
vikim08: posts the ante 50
dr.hokiday: posts the ante 50
Lotta<3: posts the ante 50
You Know No: posts the ante 50
Mr.Skapone: posts the ante 50
1LATESHOW1: posts the ante 50
malik_msk: posts the ante 50
natashaluz: posts the ante 50
natashaluz: posts small blind 200
stumpyn: posts big blind 400
*** HOLE CARDS ***
Dealt to malik_msk [7s 6c]
vikim08: folds 
dr.hokiday: folds 
Lotta<3: folds 
You Know No: folds 
Mr.Skapone: folds 
1LATESHOW1: raises 800 to 1200
malik_msk: folds 
natashaluz: folds 
stumpyn: folds 
Uncalled bet (800) returned to 1LATESHOW1
1LATESHOW1 collected 1450 from pot
*** SUMMARY ***
Total pot 1450 | Rake 0 
Seat 1: stumpyn (big blind) folded before Flop
Seat 2: vikim08 folded before Flop (didn't bet)
Seat 3: dr.hokiday folded before Flop (didn't bet)
Seat 4: Lotta<3 folded before Flop (didn't bet)
Seat 5: You Know No folded before Flop (didn't bet)
Seat 6: Mr.Skapone folded before Flop (didn't bet)
Seat 7: 1LATESHOW1 collected (1450)
Seat 8: malik_msk (button) folded before Flop (didn't bet)
Seat 9: natashaluz (small blind) folded before Flop



PokerStars Game #69710793695: Tournament #544010396, $20+$2 USD Hold'em No Limit - Level XIII (200/400) - 2011/10/29 22:16:52 MSK [2011/10/29 14:16:52 ET]
Table '544010396 89' 9-max Seat #9 is the button
Seat 1: stumpyn (5269 in chips) 
Seat 2: vikim08 (4784 in chips) 
Seat 3: dr.hokiday (7034 in chips) 
Seat 4: Lotta<3 (7132 in chips) 
Seat 5: You Know No (7373 in chips) 
Seat 6: Mr.Skapone (8706 in chips) 
Seat 7: 1LATESHOW1 (5167 in chips) 
Seat 8: malik_msk (14253 in chips) 
Seat 9: natashaluz (5553 in chips) 
stumpyn: posts the ante 50
vikim08: posts the ante 50
dr.hokiday: posts the ante 50
Lotta<3: posts the ante 50
You Know No: posts the ante 50
Mr.Skapone: posts the ante 50
1LATESHOW1: posts the ante 50
malik_msk: posts the ante 50
natashaluz: posts the ante 50
stumpyn: posts small blind 200
vikim08: posts big blind 400
*** HOLE CARDS ***
Dealt to malik_msk [Kc As]
dr.hokiday: folds 
Lotta<3: folds 
You Know No: folds 
Mr.Skapone: folds 
1LATESHOW1: folds 
malik_msk: raises 800 to 1200
natashaluz: folds 
stumpyn: folds 
vikim08: folds 
Uncalled bet (800) returned to malik_msk
malik_msk collected 1450 from pot
malik_msk: doesn't show hand 
*** SUMMARY ***
Total pot 1450 | Rake 0 
Seat 1: stumpyn (small blind) folded before Flop
Seat 2: vikim08 (big blind) folded before Flop
Seat 3: dr.hokiday folded before Flop (didn't bet)
Seat 4: Lotta<3 folded before Flop (didn't bet)
Seat 5: You Know No folded before Flop (didn't bet)
Seat 6: Mr.Skapone folded before Flop (didn't bet)
Seat 7: 1LATESHOW1 folded before Flop (didn't bet)
Seat 8: malik_msk collected (1450)
Seat 9: natashaluz (button) folded before Flop (didn't bet)



PokerStars Game #69710834117: Tournament #544010396, $20+$2 USD Hold'em No Limit - Level XIII (200/400) - 2011/10/29 22:17:35 MSK [2011/10/29 14:17:35 ET]
Table '544010396 89' 9-max Seat #1 is the button
Seat 1: stumpyn (5019 in chips) 
Seat 2: vikim08 (4334 in chips) 
Seat 3: dr.hokiday (6984 in chips) 
Seat 4: Lotta<3 (7082 in chips) 
Seat 5: You Know No (7323 in chips) 
Seat 6: Mr.Skapone (8656 in chips) 
Seat 7: 1LATESHOW1 (5117 in chips) 
Seat 8: malik_msk (15253 in chips) 
Seat 9: natashaluz (5503 in chips) 
stumpyn: posts the ante 50
vikim08: posts the ante 50
dr.hokiday: posts the ante 50
Lotta<3: posts the ante 50
You Know No: posts the ante 50
Mr.Skapone: posts the ante 50
1LATESHOW1: posts the ante 50
malik_msk: posts the ante 50
natashaluz: posts the ante 50
vikim08: posts small blind 200
dr.hokiday: posts big blind 400
*** HOLE CARDS ***
Dealt to malik_msk [5d 7c]
Lotta<3: folds 
You Know No: folds 
Mr.Skapone: folds 
1LATESHOW1: folds 
malik_msk: folds 
natashaluz: raises 800 to 1200
stumpyn: folds 
vikim08: folds 
dr.hokiday: folds 
Uncalled bet (800) returned to natashaluz
natashaluz collected 1450 from pot
*** SUMMARY ***
Total pot 1450 | Rake 0 
Seat 1: stumpyn (button) folded before Flop (didn't bet)
Seat 2: vikim08 (small blind) folded before Flop
Seat 3: dr.hokiday (big blind) folded before Flop
Seat 4: Lotta<3 folded before Flop (didn't bet)
Seat 5: You Know No folded before Flop (didn't bet)
Seat 6: Mr.Skapone folded before Flop (didn't bet)
Seat 7: 1LATESHOW1 folded before Flop (didn't bet)
Seat 8: malik_msk folded before Flop (didn't bet)
Seat 9: natashaluz collected (1450)



PokerStars Game #69710869495: Tournament #544010396, $20+$2 USD Hold'em No Limit - Level XIII (200/400) - 2011/10/29 22:18:12 MSK [2011/10/29 14:18:12 ET]
Table '544010396 89' 9-max Seat #2 is the button
Seat 1: stumpyn (4969 in chips) 
Seat 2: vikim08 (4084 in chips) 
Seat 3: dr.hokiday (6534 in chips) 
Seat 4: Lotta<3 (7032 in chips) 
Seat 5: You Know No (7273 in chips) 
Seat 6: Mr.Skapone (8606 in chips) 
Seat 7: 1LATESHOW1 (5067 in chips) 
Seat 8: malik_msk (15203 in chips) 
Seat 9: natashaluz (6503 in chips) 
stumpyn: posts the ante 50
vikim08: posts the ante 50
dr.hokiday: posts the ante 50
Lotta<3: posts the ante 50
You Know No: posts the ante 50
Mr.Skapone: posts the ante 50
1LATESHOW1: posts the ante 50
malik_msk: posts the ante 50
natashaluz: posts the ante 50
dr.hokiday: posts small blind 200
Lotta<3: posts big blind 400
*** HOLE CARDS ***
Dealt to malik_msk [8s Qc]
You Know No: folds 
Mr.Skapone: raises 600 to 1000
1LATESHOW1: folds 
malik_msk: folds 
natashaluz: folds 
stumpyn: folds 
vikim08: folds 
dr.hokiday: folds 
Lotta<3: folds 
Uncalled bet (600) returned to Mr.Skapone
Mr.Skapone collected 1450 from pot
*** SUMMARY ***
Total pot 1450 | Rake 0 
Seat 1: stumpyn folded before Flop (didn't bet)
Seat 2: vikim08 (button) folded before Flop (didn't bet)
Seat 3: dr.hokiday (small blind) folded before Flop
Seat 4: Lotta<3 (big blind) folded before Flop
Seat 5: You Know No folded before Flop (didn't bet)
Seat 6: Mr.Skapone collected (1450)
Seat 7: 1LATESHOW1 folded before Flop (didn't bet)
Seat 8: malik_msk folded before Flop (didn't bet)
Seat 9: natashaluz folded before Flop (didn't bet)



PokerStars Game #69710896138: Tournament #544010396, $20+$2 USD Hold'em No Limit - Level XIII (200/400) - 2011/10/29 22:18:40 MSK [2011/10/29 14:18:40 ET]
Table '544010396 89' 9-max Seat #3 is the button
Seat 1: stumpyn (4919 in chips) 
Seat 2: vikim08 (4034 in chips) 
Seat 3: dr.hokiday (6284 in chips) 
Seat 4: Lotta<3 (6582 in chips) 
Seat 5: You Know No (7223 in chips) 
Seat 6: Mr.Skapone (9606 in chips) 
Seat 7: 1LATESHOW1 (5017 in chips) 
Seat 8: malik_msk (15153 in chips) 
Seat 9: natashaluz (6453 in chips) 
stumpyn: posts the ante 50
vikim08: posts the ante 50
dr.hokiday: posts the ante 50
Lotta<3: posts the ante 50
You Know No: posts the ante 50
Mr.Skapone: posts the ante 50
1LATESHOW1: posts the ante 50
malik_msk: posts the ante 50
natashaluz: posts the ante 50
Lotta<3: posts small blind 200
You Know No: posts big blind 400
*** HOLE CARDS ***
Dealt to malik_msk [8c 4c]
Mr.Skapone: folds 
1LATESHOW1: folds 
malik_msk: folds 
natashaluz: calls 400
stumpyn: folds 
vikim08: folds 
dr.hokiday: folds 
Lotta<3: folds 
You Know No: checks 
*** FLOP *** [5s Qh Qc]
You Know No: checks 
natashaluz: checks 
*** TURN *** [5s Qh Qc] [9s]
You Know No: checks 
natashaluz: bets 800
You Know No: folds 
Uncalled bet (800) returned to natashaluz
natashaluz collected 1450 from pot
*** SUMMARY ***
Total pot 1450 | Rake 0 
Board [5s Qh Qc 9s]
Seat 1: stumpyn folded before Flop (didn't bet)
Seat 2: vikim08 folded before Flop (didn't bet)
Seat 3: dr.hokiday (button) folded before Flop (didn't bet)
Seat 4: Lotta<3 (small blind) folded before Flop
Seat 5: You Know No (big blind) folded on the Turn
Seat 6: Mr.Skapone folded before Flop (didn't bet)
Seat 7: 1LATESHOW1 folded before Flop (didn't bet)
Seat 8: malik_msk folded before Flop (didn't bet)
Seat 9: natashaluz collected (1450)



PokerStars Game #69710974387: Tournament #544010396, $20+$2 USD Hold'em No Limit - Level XIII (200/400) - 2011/10/29 22:20:04 MSK [2011/10/29 14:20:04 ET]
Table '544010396 89' 9-max Seat #4 is the button
Seat 1: stumpyn (4869 in chips) 
Seat 2: vikim08 (3984 in chips) 
Seat 3: dr.hokiday (6234 in chips) 
Seat 4: Lotta<3 (6332 in chips) 
Seat 5: You Know No (6773 in chips) 
Seat 6: Mr.Skapone (9556 in chips) 
Seat 7: 1LATESHOW1 (4967 in chips) 
Seat 8: malik_msk (15103 in chips) 
Seat 9: natashaluz (7453 in chips) 
stumpyn: posts the ante 50
vikim08: posts the ante 50
dr.hokiday: posts the ante 50
Lotta<3: posts the ante 50
You Know No: posts the ante 50
Mr.Skapone: posts the ante 50
1LATESHOW1: posts the ante 50
malik_msk: posts the ante 50
natashaluz: posts the ante 50
You Know No: posts small blind 200
Mr.Skapone: posts big blind 400
*** HOLE CARDS ***
Dealt to malik_msk [8d 2c]
1LATESHOW1: folds 
malik_msk: folds 
natashaluz: folds 
stumpyn: folds 
vikim08: folds 
dr.hokiday: raises 800 to 1200
Lotta<3: folds 
You Know No: folds 
Mr.Skapone: folds 
Uncalled bet (800) returned to dr.hokiday
dr.hokiday collected 1450 from pot
*** SUMMARY ***
Total pot 1450 | Rake 0 
Seat 1: stumpyn folded before Flop (didn't bet)
Seat 2: vikim08 folded before Flop (didn't bet)
Seat 3: dr.hokiday collected (1450)
Seat 4: Lotta<3 (button) folded before Flop (didn't bet)
Seat 5: You Know No (small blind) folded before Flop
Seat 6: Mr.Skapone (big blind) folded before Flop
Seat 7: 1LATESHOW1 folded before Flop (didn't bet)
Seat 8: malik_msk folded before Flop (didn't bet)
Seat 9: natashaluz folded before Flop (didn't bet)



PokerStars Game #69710997584: Tournament #544010396, $20+$2 USD Hold'em No Limit - Level XIII (200/400) - 2011/10/29 22:20:29 MSK [2011/10/29 14:20:29 ET]
Table '544010396 89' 9-max Seat #5 is the button
Seat 1: stumpyn (4819 in chips) 
Seat 2: vikim08 (3934 in chips) 
Seat 3: dr.hokiday (7234 in chips) 
Seat 4: Lotta<3 (6282 in chips) 
Seat 5: You Know No (6523 in chips) 
Seat 6: Mr.Skapone (9106 in chips) 
Seat 7: 1LATESHOW1 (4917 in chips) 
Seat 8: malik_msk (15053 in chips) 
Seat 9: natashaluz (7403 in chips) 
stumpyn: posts the ante 50
vikim08: posts the ante 50
dr.hokiday: posts the ante 50
Lotta<3: posts the ante 50
You Know No: posts the ante 50
Mr.Skapone: posts the ante 50
1LATESHOW1: posts the ante 50
malik_msk: posts the ante 50
natashaluz: posts the ante 50
Mr.Skapone: posts small blind 200
1LATESHOW1: posts big blind 400
*** HOLE CARDS ***
Dealt to malik_msk [3h 2h]
malik_msk: folds 
natashaluz: folds 
stumpyn: folds 
vikim08: folds 
dr.hokiday: folds 
Lotta<3: folds 
You Know No: raises 800 to 1200
Mr.Skapone: folds 
1LATESHOW1: folds 
Uncalled bet (800) returned to You Know No
You Know No collected 1450 from pot
You Know No: doesn't show hand 
*** SUMMARY ***
Total pot 1450 | Rake 0 
Seat 1: stumpyn folded before Flop (didn't bet)
Seat 2: vikim08 folded before Flop (didn't bet)
Seat 3: dr.hokiday folded before Flop (didn't bet)
Seat 4: Lotta<3 folded before Flop (didn't bet)
Seat 5: You Know No (button) collected (1450)
Seat 6: Mr.Skapone (small blind) folded before Flop
Seat 7: 1LATESHOW1 (big blind) folded before Flop
Seat 8: malik_msk folded before Flop (didn't bet)
Seat 9: natashaluz folded before Flop (didn't bet)



PokerStars Game #69711027197: Tournament #544010396, $20+$2 USD Hold'em No Limit - Level XIII (200/400) - 2011/10/29 22:21:00 MSK [2011/10/29 14:21:00 ET]
Table '544010396 89' 9-max Seat #6 is the button
Seat 1: stumpyn (4769 in chips) 
Seat 2: vikim08 (3884 in chips) 
Seat 3: dr.hokiday (7184 in chips) 
Seat 4: Lotta<3 (6232 in chips) 
Seat 5: You Know No (7523 in chips) 
Seat 6: Mr.Skapone (8856 in chips) 
Seat 7: 1LATESHOW1 (4467 in chips) 
Seat 8: malik_msk (15003 in chips) 
Seat 9: natashaluz (7353 in chips) 
stumpyn: posts the ante 50
vikim08: posts the ante 50
dr.hokiday: posts the ante 50
Lotta<3: posts the ante 50
You Know No: posts the ante 50
Mr.Skapone: posts the ante 50
1LATESHOW1: posts the ante 50
malik_msk: posts the ante 50
natashaluz: posts the ante 50
1LATESHOW1: posts small blind 200
malik_msk: posts big blind 400
*** HOLE CARDS ***
Dealt to malik_msk [3s Qs]
natashaluz: folds 
stumpyn: folds 
vikim08: folds 
dr.hokiday: raises 6734 to 7134 and is all-in
Lotta<3: folds 
You Know No: folds 
Mr.Skapone: folds 
1LATESHOW1: folds 
malik_msk: folds 
Uncalled bet (6734) returned to dr.hokiday
dr.hokiday collected 1450 from pot
*** SUMMARY ***
Total pot 1450 | Rake 0 
Seat 1: stumpyn folded before Flop (didn't bet)
Seat 2: vikim08 folded before Flop (didn't bet)
Seat 3: dr.hokiday collected (1450)
Seat 4: Lotta<3 folded before Flop (didn't bet)
Seat 5: You Know No folded before Flop (didn't bet)
Seat 6: Mr.Skapone (button) folded before Flop (didn't bet)
Seat 7: 1LATESHOW1 (small blind) folded before Flop
Seat 8: malik_msk (big blind) folded before Flop
Seat 9: natashaluz folded before Flop (didn't bet)



PokerStars Game #69711052944: Tournament #544010396, $20+$2 USD Hold'em No Limit - Level XIII (200/400) - 2011/10/29 22:21:28 MSK [2011/10/29 14:21:28 ET]
Table '544010396 89' 9-max Seat #7 is the button
Seat 1: stumpyn (4719 in chips) 
Seat 2: vikim08 (3834 in chips) 
Seat 3: dr.hokiday (8184 in chips) 
Seat 4: Lotta<3 (6182 in chips) 
Seat 5: You Know No (7473 in chips) 
Seat 6: Mr.Skapone (8806 in chips) 
Seat 7: 1LATESHOW1 (4217 in chips) 
Seat 8: malik_msk (14553 in chips) 
Seat 9: natashaluz (7303 in chips) 
stumpyn: posts the ante 50
vikim08: posts the ante 50
dr.hokiday: posts the ante 50
Lotta<3: posts the ante 50
You Know No: posts the ante 50
Mr.Skapone: posts the ante 50
1LATESHOW1: posts the ante 50
malik_msk: posts the ante 50
natashaluz: posts the ante 50
malik_msk: posts small blind 200
natashaluz: posts big blind 400
*** HOLE CARDS ***
Dealt to malik_msk [7d Jd]
stumpyn: folds 
vikim08: folds 
dr.hokiday: folds 
Lotta<3: folds 
You Know No: folds 
Mr.Skapone: folds 
1LATESHOW1: folds 
malik_msk: raises 800 to 1200
natashaluz: raises 6053 to 7253 and is all-in
malik_msk: folds 
Uncalled bet (6053) returned to natashaluz
natashaluz collected 2850 from pot
*** SUMMARY ***
Total pot 2850 | Rake 0 
Seat 1: stumpyn folded before Flop (didn't bet)
Seat 2: vikim08 folded before Flop (didn't bet)
Seat 3: dr.hokiday folded before Flop (didn't bet)
Seat 4: Lotta<3 folded before Flop (didn't bet)
Seat 5: You Know No folded before Flop (didn't bet)
Seat 6: Mr.Skapone folded before Flop (didn't bet)
Seat 7: 1LATESHOW1 (button) folded before Flop (didn't bet)
Seat 8: malik_msk (small blind) folded before Flop
Seat 9: natashaluz (big blind) collected (2850)



PokerStars Game #69711080219: Tournament #544010396, $20+$2 USD Hold'em No Limit - Level XIII (200/400) - 2011/10/29 22:21:57 MSK [2011/10/29 14:21:57 ET]
Table '544010396 89' 9-max Seat #8 is the button
Seat 1: stumpyn (4669 in chips) 
Seat 2: vikim08 (3784 in chips) 
Seat 3: dr.hokiday (8134 in chips) 
Seat 4: Lotta<3 (6132 in chips) 
Seat 5: You Know No (7423 in chips) 
Seat 6: Mr.Skapone (8756 in chips) 
Seat 7: 1LATESHOW1 (4167 in chips) 
Seat 8: malik_msk (13303 in chips) 
Seat 9: natashaluz (8903 in chips) 
stumpyn: posts the ante 50
vikim08: posts the ante 50
dr.hokiday: posts the ante 50
Lotta<3: posts the ante 50
You Know No: posts the ante 50
Mr.Skapone: posts the ante 50
1LATESHOW1: posts the ante 50
malik_msk: posts the ante 50
natashaluz: posts the ante 50
natashaluz: posts small blind 200
stumpyn: posts big blind 400
*** HOLE CARDS ***
Dealt to malik_msk [Ah 7s]
vikim08: folds 
dr.hokiday: folds 
Lotta<3: raises 440 to 840
You Know No: folds 
Mr.Skapone: folds 
1LATESHOW1: folds 
malik_msk: calls 840
natashaluz: folds 
stumpyn: folds 
*** FLOP *** [9s 3s 2s]
Lotta<3: bets 709
malik_msk: raises 2091 to 2800
Lotta<3: folds 
Uncalled bet (2091) returned to malik_msk
malik_msk collected 4148 from pot
malik_msk: doesn't show hand 
*** SUMMARY ***
Total pot 4148 | Rake 0 
Board [9s 3s 2s]
Seat 1: stumpyn (big blind) folded before Flop
Seat 2: vikim08 folded before Flop (didn't bet)
Seat 3: dr.hokiday folded before Flop (didn't bet)
Seat 4: Lotta<3 folded on the Flop
Seat 5: You Know No folded before Flop (didn't bet)
Seat 6: Mr.Skapone folded before Flop (didn't bet)
Seat 7: 1LATESHOW1 folded before Flop (didn't bet)
Seat 8: malik_msk (button) collected (4148)
Seat 9: natashaluz (small blind) folded before Flop



PokerStars Game #69711147431: Tournament #544010396, $20+$2 USD Hold'em No Limit - Level XIII (200/400) - 2011/10/29 22:23:09 MSK [2011/10/29 14:23:09 ET]
Table '544010396 89' 9-max Seat #9 is the button
Seat 1: stumpyn (4219 in chips) 
Seat 2: vikim08 (3734 in chips) 
Seat 3: dr.hokiday (8084 in chips) 
Seat 4: Lotta<3 (4533 in chips) 
Seat 5: You Know No (7373 in chips) 
Seat 6: Mr.Skapone (8706 in chips) 
Seat 7: 1LATESHOW1 (4117 in chips) 
Seat 8: malik_msk (15852 in chips) 
Seat 9: natashaluz (8653 in chips) 
stumpyn: posts the ante 50
vikim08: posts the ante 50
dr.hokiday: posts the ante 50
Lotta<3: posts the ante 50
You Know No: posts the ante 50
Mr.Skapone: posts the ante 50
1LATESHOW1: posts the ante 50
malik_msk: posts the ante 50
natashaluz: posts the ante 50
stumpyn: posts small blind 200
vikim08: posts big blind 400
*** HOLE CARDS ***
Dealt to malik_msk [9c 4d]
dr.hokiday: folds 
Lotta<3: folds 
You Know No: folds 
Mr.Skapone: folds 
1LATESHOW1: folds 
malik_msk: folds 
natashaluz: folds 
stumpyn: folds 
Uncalled bet (200) returned to vikim08
vikim08 collected 850 from pot
*** SUMMARY ***
Total pot 850 | Rake 0 
Seat 1: stumpyn (small blind) folded before Flop
Seat 2: vikim08 (big blind) collected (850)
Seat 3: dr.hokiday folded before Flop (didn't bet)
Seat 4: Lotta<3 folded before Flop (didn't bet)
Seat 5: You Know No folded before Flop (didn't bet)
Seat 6: Mr.Skapone folded before Flop (didn't bet)
Seat 7: 1LATESHOW1 folded before Flop (didn't bet)
Seat 8: malik_msk folded before Flop (didn't bet)
Seat 9: natashaluz (button) folded before Flop (didn't bet)



PokerStars Game #69711173246: Tournament #544010396, $20+$2 USD Hold'em No Limit - Level XIII (200/400) - 2011/10/29 22:23:37 MSK [2011/10/29 14:23:37 ET]
Table '544010396 89' 9-max Seat #1 is the button
Seat 1: stumpyn (3969 in chips) 
Seat 2: vikim08 (4334 in chips) 
Seat 3: dr.hokiday (8034 in chips) 
Seat 4: Lotta<3 (4483 in chips) 
Seat 5: You Know No (7323 in chips) 
Seat 6: Mr.Skapone (8656 in chips) 
Seat 7: 1LATESHOW1 (4067 in chips) 
Seat 8: malik_msk (15802 in chips) 
Seat 9: natashaluz (8603 in chips) 
stumpyn: posts the ante 50
vikim08: posts the ante 50
dr.hokiday: posts the ante 50
Lotta<3: posts the ante 50
You Know No: posts the ante 50
Mr.Skapone: posts the ante 50
1LATESHOW1: posts the ante 50
malik_msk: posts the ante 50
natashaluz: posts the ante 50
vikim08: posts small blind 200
dr.hokiday: posts big blind 400
*** HOLE CARDS ***
Dealt to malik_msk [2s 3s]
Lotta<3: folds 
You Know No: folds 
Mr.Skapone: raises 449 to 849
1LATESHOW1: folds 
malik_msk: folds 
natashaluz: folds 
stumpyn: folds 
vikim08: raises 1151 to 2000
dr.hokiday: folds 
Mr.Skapone: folds 
Uncalled bet (1151) returned to vikim08
vikim08 collected 2548 from pot
*** SUMMARY ***
Total pot 2548 | Rake 0 
Seat 1: stumpyn (button) folded before Flop (didn't bet)
Seat 2: vikim08 (small blind) collected (2548)
Seat 3: dr.hokiday (big blind) folded before Flop
Seat 4: Lotta<3 folded before Flop (didn't bet)
Seat 5: You Know No folded before Flop (didn't bet)
Seat 6: Mr.Skapone folded before Flop
Seat 7: 1LATESHOW1 folded before Flop (didn't bet)
Seat 8: malik_msk folded before Flop (didn't bet)
Seat 9: natashaluz folded before Flop (didn't bet)



PokerStars Game #69711224009: Tournament #544010396, $20+$2 USD Hold'em No Limit - Level XIV (250/500) - 2011/10/29 22:24:32 MSK [2011/10/29 14:24:32 ET]
Table '544010396 89' 9-max Seat #2 is the button
Seat 1: stumpyn (3919 in chips) 
Seat 2: vikim08 (5983 in chips) 
Seat 3: dr.hokiday (7584 in chips) 
Seat 4: Lotta<3 (4433 in chips) 
Seat 5: You Know No (7273 in chips) 
Seat 6: Mr.Skapone (7757 in chips) 
Seat 7: 1LATESHOW1 (4017 in chips) 
Seat 8: malik_msk (15752 in chips) 
Seat 9: natashaluz (8553 in chips) 
stumpyn: posts the ante 60
vikim08: posts the ante 60
dr.hokiday: posts the ante 60
Lotta<3: posts the ante 60
You Know No: posts the ante 60
Mr.Skapone: posts the ante 60
1LATESHOW1: posts the ante 60
malik_msk: posts the ante 60
natashaluz: posts the ante 60
dr.hokiday: posts small blind 250
Lotta<3: posts big blind 500
*** HOLE CARDS ***
Dealt to malik_msk [5s Jd]
You Know No: folds 
Mr.Skapone: folds 
1LATESHOW1: raises 3457 to 3957 and is all-in
malik_msk: folds 
natashaluz: folds 
stumpyn: folds 
vikim08: folds 
dr.hokiday: folds 
Lotta<3: calls 3457
*** FLOP *** [Jc 3c 2c]
*** TURN *** [Jc 3c 2c] [3d]
*** RIVER *** [Jc 3c 2c 3d] [8d]
*** SHOW DOWN ***
Lotta<3: shows [9h 9c] (two pair, Nines and Threes)
1LATESHOW1: shows [3s As] (three of a kind, Threes)
1LATESHOW1 collected 8704 from pot
*** SUMMARY ***
Total pot 8704 | Rake 0 
Board [Jc 3c 2c 3d 8d]
Seat 1: stumpyn folded before Flop (didn't bet)
Seat 2: vikim08 (button) folded before Flop (didn't bet)
Seat 3: dr.hokiday (small blind) folded before Flop
Seat 4: Lotta<3 (big blind) showed [9h 9c] and lost with two pair, Nines and Threes
Seat 5: You Know No folded before Flop (didn't bet)
Seat 6: Mr.Skapone folded before Flop (didn't bet)
Seat 7: 1LATESHOW1 showed [3s As] and won (8704) with three of a kind, Threes
Seat 8: malik_msk folded before Flop (didn't bet)
Seat 9: natashaluz folded before Flop (didn't bet)



PokerStars Game #69711259116: Tournament #544010396, $20+$2 USD Hold'em No Limit - Level XIV (250/500) - 2011/10/29 22:25:11 MSK [2011/10/29 14:25:11 ET]
Table '544010396 89' 9-max Seat #3 is the button
Seat 1: stumpyn (3859 in chips) 
Seat 2: vikim08 (5923 in chips) 
Seat 3: dr.hokiday (7274 in chips) 
Seat 4: Lotta<3 (416 in chips) 
Seat 5: You Know No (7213 in chips) 
Seat 6: Mr.Skapone (7697 in chips) 
Seat 7: 1LATESHOW1 (8704 in chips) 
Seat 8: malik_msk (15692 in chips) 
Seat 9: natashaluz (8493 in chips) 
stumpyn: posts the ante 60
vikim08: posts the ante 60
dr.hokiday: posts the ante 60
Lotta<3: posts the ante 60
You Know No: posts the ante 60
Mr.Skapone: posts the ante 60
1LATESHOW1: posts the ante 60
malik_msk: posts the ante 60
natashaluz: posts the ante 60
Lotta<3: posts small blind 250
You Know No: posts big blind 500
*** HOLE CARDS ***
Dealt to malik_msk [Ks Js]
Mr.Skapone: folds 
1LATESHOW1: folds 
malik_msk: raises 500 to 1000
natashaluz: raises 1500 to 2500
stumpyn: folds 
vikim08: folds 
dr.hokiday: folds 
Lotta<3: calls 106 and is all-in
You Know No: folds 
malik_msk: calls 1500
*** FLOP *** [2c 6h Jc]
malik_msk: bets 13132 and is all-in
natashaluz: calls 5933 and is all-in
Uncalled bet (7199) returned to malik_msk
*** TURN *** [2c 6h Jc] [Jh]
*** RIVER *** [2c 6h Jc Jh] [Td]
*** SHOW DOWN ***
malik_msk: shows [Ks Js] (three of a kind, Jacks)
natashaluz: shows [Qs Qc] (two pair, Queens and Jacks)
malik_msk collected 16298 from side pot
Lotta<3: shows [7s 8s] (a pair of Jacks)
malik_msk collected 1964 from main pot
natashaluz finished the tournament in 717th place
Lotta<3 finished the tournament in 718th place
Ferenc35 is connected 
*** SUMMARY ***
Total pot 18262 Main pot 1964. Side pot 16298. | Rake 0 
Board [2c 6h Jc Jh Td]
Seat 1: stumpyn folded before Flop (didn't bet)
Seat 2: vikim08 folded before Flop (didn't bet)
Seat 3: dr.hokiday (button) folded before Flop (didn't bet)
Seat 4: Lotta<3 (small blind) showed [7s 8s] and lost with a pair of Jacks
Seat 5: You Know No (big blind) folded before Flop
Seat 6: Mr.Skapone folded before Flop (didn't bet)
Seat 7: 1LATESHOW1 folded before Flop (didn't bet)
Seat 8: malik_msk showed [Ks Js] and won (18262) with three of a kind, Jacks
Seat 9: natashaluz showed [Qs Qc] and lost with two pair, Queens and Jacks



PokerStars Game #69711302189: Tournament #544010396, $20+$2 USD Hold'em No Limit - Level XIV (250/500) - 2011/10/29 22:25:57 MSK [2011/10/29 14:25:57 ET]
Table '544010396 89' 9-max Seat #5 is the button
Seat 1: stumpyn (3799 in chips) 
Seat 2: vikim08 (5863 in chips) 
Seat 3: dr.hokiday (7214 in chips) 
Seat 5: You Know No (6653 in chips) 
Seat 6: Mr.Skapone (7637 in chips) 
Seat 7: 1LATESHOW1 (8644 in chips) 
Seat 8: malik_msk (25461 in chips) 
Seat 9: Ferenc35 (18858 in chips) 
stumpyn: posts the ante 60
vikim08: posts the ante 60
dr.hokiday: posts the ante 60
You Know No: posts the ante 60
Mr.Skapone: posts the ante 60
1LATESHOW1: posts the ante 60
malik_msk: posts the ante 60
Ferenc35: posts the ante 60
Mr.Skapone: posts small blind 250
1LATESHOW1: posts big blind 500
*** HOLE CARDS ***
Dealt to malik_msk [Kd 9d]
malik_msk: folds 
Ferenc35: folds 
londrino is connected 
stumpyn: folds 
vikim08: folds 
dr.hokiday: folds 
You Know No: folds 
Mr.Skapone: folds 
Uncalled bet (250) returned to 1LATESHOW1
1LATESHOW1 collected 980 from pot
*** SUMMARY ***
Total pot 980 | Rake 0 
Seat 1: stumpyn folded before Flop (didn't bet)
Seat 2: vikim08 folded before Flop (didn't bet)
Seat 3: dr.hokiday folded before Flop (didn't bet)
Seat 5: You Know No (button) folded before Flop (didn't bet)
Seat 6: Mr.Skapone (small blind) folded before Flop
Seat 7: 1LATESHOW1 (big blind) collected (980)
Seat 8: malik_msk folded before Flop (didn't bet)
Seat 9: Ferenc35 folded before Flop (didn't bet)



PokerStars Game #69711339731: Tournament #544010396, $20+$2 USD Hold'em No Limit - Level XIV (250/500) - 2011/10/29 22:26:37 MSK [2011/10/29 14:26:37 ET]
Table '544010396 89' 9-max Seat #6 is the button
Seat 1: stumpyn (3739 in chips) 
Seat 2: vikim08 (5803 in chips) 
Seat 3: dr.hokiday (7154 in chips) 
Seat 4: londrino (17120 in chips) 
Seat 5: You Know No (6593 in chips) 
Seat 6: Mr.Skapone (7327 in chips) 
Seat 7: 1LATESHOW1 (9314 in chips) 
Seat 8: malik_msk (25401 in chips) 
Seat 9: Ferenc35 (18798 in chips) 
stumpyn: posts the ante 60
vikim08: posts the ante 60
dr.hokiday: posts the ante 60
londrino: posts the ante 60
You Know No: posts the ante 60
Mr.Skapone: posts the ante 60
1LATESHOW1: posts the ante 60
malik_msk: posts the ante 60
Ferenc35: posts the ante 60
1LATESHOW1: posts small blind 250
malik_msk: posts big blind 500
*** HOLE CARDS ***
Dealt to malik_msk [3d 8s]
Ferenc35: folds 
stumpyn: folds 
vikim08: folds 
dr.hokiday: folds 
londrino: folds 
You Know No: folds 
Mr.Skapone: folds 
1LATESHOW1: folds 
Uncalled bet (250) returned to malik_msk
malik_msk collected 1040 from pot
malik_msk: doesn't show hand 
*** SUMMARY ***
Total pot 1040 | Rake 0 
Seat 1: stumpyn folded before Flop (didn't bet)
Seat 2: vikim08 folded before Flop (didn't bet)
Seat 3: dr.hokiday folded before Flop (didn't bet)
Seat 4: londrino folded before Flop (didn't bet)
Seat 5: You Know No folded before Flop (didn't bet)
Seat 6: Mr.Skapone (button) folded before Flop (didn't bet)
Seat 7: 1LATESHOW1 (small blind) folded before Flop
Seat 8: malik_msk (big blind) collected (1040)
Seat 9: Ferenc35 folded before Flop (didn't bet)



PokerStars Game #69711358428: Tournament #544010396, $20+$2 USD Hold'em No Limit - Level XIV (250/500) - 2011/10/29 22:26:58 MSK [2011/10/29 14:26:58 ET]
Table '544010396 89' 9-max Seat #7 is the button
Seat 1: stumpyn (3679 in chips) 
Seat 2: vikim08 (5743 in chips) 
Seat 3: dr.hokiday (7094 in chips) 
Seat 4: londrino (17060 in chips) 
Seat 5: You Know No (6533 in chips) 
Seat 6: Mr.Skapone (7267 in chips) 
Seat 7: 1LATESHOW1 (9004 in chips) 
Seat 8: malik_msk (26131 in chips) 
Seat 9: Ferenc35 (18738 in chips) 
stumpyn: posts the ante 60
vikim08: posts the ante 60
dr.hokiday: posts the ante 60
londrino: posts the ante 60
You Know No: posts the ante 60
Mr.Skapone: posts the ante 60
1LATESHOW1: posts the ante 60
malik_msk: posts the ante 60
Ferenc35: posts the ante 60
malik_msk: posts small blind 250
Ferenc35: posts big blind 500
*** HOLE CARDS ***
Dealt to malik_msk [5c Ac]
stumpyn: folds 
vikim08: folds 
dr.hokiday: folds 
londrino: folds 
You Know No: folds 
Mr.Skapone: folds 
1LATESHOW1: folds 
malik_msk: raises 1500 to 2000
Ferenc35: folds 
Uncalled bet (1500) returned to malik_msk
malik_msk collected 1540 from pot
malik_msk: doesn't show hand 
*** SUMMARY ***
Total pot 1540 | Rake 0 
Seat 1: stumpyn folded before Flop (didn't bet)
Seat 2: vikim08 folded before Flop (didn't bet)
Seat 3: dr.hokiday folded before Flop (didn't bet)
Seat 4: londrino folded before Flop (didn't bet)
Seat 5: You Know No folded before Flop (didn't bet)
Seat 6: Mr.Skapone folded before Flop (didn't bet)
Seat 7: 1LATESHOW1 (button) folded before Flop (didn't bet)
Seat 8: malik_msk (small blind) collected (1540)
Seat 9: Ferenc35 (big blind) folded before Flop



PokerStars Game #69711389029: Tournament #544010396, $20+$2 USD Hold'em No Limit - Level XIV (250/500) - 2011/10/29 22:27:31 MSK [2011/10/29 14:27:31 ET]
Table '544010396 89' 9-max Seat #8 is the button
Seat 1: stumpyn (3619 in chips) 
Seat 2: vikim08 (5683 in chips) 
Seat 3: dr.hokiday (7034 in chips) 
Seat 4: londrino (17000 in chips) 
Seat 5: You Know No (6473 in chips) 
Seat 6: Mr.Skapone (7207 in chips) 
Seat 7: 1LATESHOW1 (8944 in chips) 
Seat 8: malik_msk (27111 in chips) 
Seat 9: Ferenc35 (18178 in chips) 
stumpyn: posts the ante 60
vikim08: posts the ante 60
dr.hokiday: posts the ante 60
londrino: posts the ante 60
You Know No: posts the ante 60
Mr.Skapone: posts the ante 60
1LATESHOW1: posts the ante 60
malik_msk: posts the ante 60
Ferenc35: posts the ante 60
Ferenc35: posts small blind 250
stumpyn: posts big blind 500
*** HOLE CARDS ***
Dealt to malik_msk [Ks 8h]
vikim08: folds 
dr.hokiday: folds 
londrino: folds 
You Know No: folds 
Mr.Skapone: raises 6647 to 7147 and is all-in
1LATESHOW1: folds 
malik_msk: folds 
Ferenc35: folds 
stumpyn: calls 3059 and is all-in
Uncalled bet (3588) returned to Mr.Skapone
*** FLOP *** [2s 6h Jh]
*** TURN *** [2s 6h Jh] [5c]
*** RIVER *** [2s 6h Jh 5c] [Kh]
*** SHOW DOWN ***
stumpyn: shows [Kc Td] (a pair of Kings)
Mr.Skapone: shows [Jc Tc] (a pair of Jacks)
stumpyn collected 7908 from pot
*** SUMMARY ***
Total pot 7908 | Rake 0 
Board [2s 6h Jh 5c Kh]
Seat 1: stumpyn (big blind) showed [Kc Td] and won (7908) with a pair of Kings
Seat 2: vikim08 folded before Flop (didn't bet)
Seat 3: dr.hokiday folded before Flop (didn't bet)
Seat 4: londrino folded before Flop (didn't bet)
Seat 5: You Know No folded before Flop (didn't bet)
Seat 6: Mr.Skapone showed [Jc Tc] and lost with a pair of Jacks
Seat 7: 1LATESHOW1 folded before Flop (didn't bet)
Seat 8: malik_msk (button) folded before Flop (didn't bet)
Seat 9: Ferenc35 (small blind) folded before Flop



PokerStars Game #69711422374: Tournament #544010396, $20+$2 USD Hold'em No Limit - Level XIV (250/500) - 2011/10/29 22:28:07 MSK [2011/10/29 14:28:07 ET]
Table '544010396 89' 9-max Seat #9 is the button
Seat 1: stumpyn (7908 in chips) 
Seat 2: vikim08 (5623 in chips) 
Seat 3: dr.hokiday (6974 in chips) 
Seat 4: londrino (16940 in chips) 
Seat 5: You Know No (6413 in chips) 
Seat 6: Mr.Skapone (3588 in chips) 
Seat 7: 1LATESHOW1 (8884 in chips) 
Seat 8: malik_msk (27051 in chips) 
Seat 9: Ferenc35 (17868 in chips) 
stumpyn: posts the ante 60
vikim08: posts the ante 60
dr.hokiday: posts the ante 60
londrino: posts the ante 60
You Know No: posts the ante 60
Mr.Skapone: posts the ante 60
1LATESHOW1: posts the ante 60
malik_msk: posts the ante 60
Ferenc35: posts the ante 60
stumpyn: posts small blind 250
vikim08: posts big blind 500
*** HOLE CARDS ***
Dealt to malik_msk [Ac Td]
dr.hokiday: folds 
londrino: folds 
You Know No: folds 
Mr.Skapone: folds 
1LATESHOW1: folds 
malik_msk: calls 500
Ferenc35: folds 
stumpyn: calls 250
vikim08: checks 
*** FLOP *** [Ks 8h Tc]
stumpyn: checks 
vikim08: checks 
malik_msk: checks 
*** TURN *** [Ks 8h Tc] [8d]
stumpyn: checks 
vikim08: checks 
malik_msk: bets 1000
stumpyn: folds 
vikim08: folds 
Uncalled bet (1000) returned to malik_msk
malik_msk collected 2040 from pot
malik_msk: doesn't show hand 
*** SUMMARY ***
Total pot 2040 | Rake 0 
Board [Ks 8h Tc 8d]
Seat 1: stumpyn (small blind) folded on the Turn
Seat 2: vikim08 (big blind) folded on the Turn
Seat 3: dr.hokiday folded before Flop (didn't bet)
Seat 4: londrino folded before Flop (didn't bet)
Seat 5: You Know No folded before Flop (didn't bet)
Seat 6: Mr.Skapone folded before Flop (didn't bet)
Seat 7: 1LATESHOW1 folded before Flop (didn't bet)
Seat 8: malik_msk collected (2040)
Seat 9: Ferenc35 (button) folded before Flop (didn't bet)



PokerStars Game #69711496073: Tournament #544010396, $20+$2 USD Hold'em No Limit - Level XIV (250/500) - 2011/10/29 22:29:27 MSK [2011/10/29 14:29:27 ET]
Table '544010396 89' 9-max Seat #1 is the button
Seat 1: stumpyn (7348 in chips) 
Seat 2: vikim08 (5063 in chips) 
Seat 3: dr.hokiday (6914 in chips) 
Seat 4: londrino (16880 in chips) 
Seat 5: You Know No (6353 in chips) 
Seat 6: Mr.Skapone (3528 in chips) 
Seat 7: 1LATESHOW1 (8824 in chips) 
Seat 8: malik_msk (28531 in chips) 
Seat 9: Ferenc35 (17808 in chips) 
stumpyn: posts the ante 60
vikim08: posts the ante 60
dr.hokiday: posts the ante 60
londrino: posts the ante 60
You Know No: posts the ante 60
Mr.Skapone: posts the ante 60
1LATESHOW1: posts the ante 60
malik_msk: posts the ante 60
Ferenc35: posts the ante 60
vikim08: posts small blind 250
dr.hokiday: posts big blind 500
*** HOLE CARDS ***
Dealt to malik_msk [2c Th]
londrino: folds 
You Know No: folds 
Mr.Skapone: raises 2968 to 3468 and is all-in
1LATESHOW1: folds 
malik_msk: folds 
Ferenc35: folds 
stumpyn: folds 
vikim08: folds 
dr.hokiday: folds 
Uncalled bet (2968) returned to Mr.Skapone
Mr.Skapone collected 1790 from pot
*** SUMMARY ***
Total pot 1790 | Rake 0 
Seat 1: stumpyn (button) folded before Flop (didn't bet)
Seat 2: vikim08 (small blind) folded before Flop
Seat 3: dr.hokiday (big blind) folded before Flop
Seat 4: londrino folded before Flop (didn't bet)
Seat 5: You Know No folded before Flop (didn't bet)
Seat 6: Mr.Skapone collected (1790)
Seat 7: 1LATESHOW1 folded before Flop (didn't bet)
Seat 8: malik_msk folded before Flop (didn't bet)
Seat 9: Ferenc35 folded before Flop (didn't bet)



PokerStars Game #69711518415: Tournament #544010396, $20+$2 USD Hold'em No Limit - Level XIV (250/500) - 2011/10/29 22:29:51 MSK [2011/10/29 14:29:51 ET]
Table '544010396 89' 9-max Seat #2 is the button
Seat 1: stumpyn (7288 in chips) 
Seat 2: vikim08 (4753 in chips) 
Seat 3: dr.hokiday (6354 in chips) 
Seat 4: londrino (16820 in chips) 
Seat 5: You Know No (6293 in chips) 
Seat 6: Mr.Skapone (4758 in chips) 
Seat 7: 1LATESHOW1 (8764 in chips) 
Seat 8: malik_msk (28471 in chips) 
Seat 9: Ferenc35 (17748 in chips) 
stumpyn: posts the ante 60
vikim08: posts the ante 60
dr.hokiday: posts the ante 60
londrino: posts the ante 60
You Know No: posts the ante 60
Mr.Skapone: posts the ante 60
1LATESHOW1: posts the ante 60
malik_msk: posts the ante 60
Ferenc35: posts the ante 60
dr.hokiday: posts small blind 250
londrino: posts big blind 500
*** HOLE CARDS ***
Dealt to malik_msk [2c Ts]
You Know No: folds 
Mr.Skapone: folds 
1LATESHOW1: folds 
malik_msk: folds 
Ferenc35: folds 
stumpyn: folds 
vikim08: folds 
dr.hokiday: raises 5794 to 6294 and is all-in
londrino: folds 
Uncalled bet (5794) returned to dr.hokiday
dr.hokiday collected 1540 from pot
*** SUMMARY ***
Total pot 1540 | Rake 0 
Seat 1: stumpyn folded before Flop (didn't bet)
Seat 2: vikim08 (button) folded before Flop (didn't bet)
Seat 3: dr.hokiday (small blind) collected (1540)
Seat 4: londrino (big blind) folded before Flop
Seat 5: You Know No folded before Flop (didn't bet)
Seat 6: Mr.Skapone folded before Flop (didn't bet)
Seat 7: 1LATESHOW1 folded before Flop (didn't bet)
Seat 8: malik_msk folded before Flop (didn't bet)
Seat 9: Ferenc35 folded before Flop (didn't bet)



PokerStars Game #69711549020: Tournament #544010396, $20+$2 USD Hold'em No Limit - Level XIV (250/500) - 2011/10/29 22:30:23 MSK [2011/10/29 14:30:23 ET]
Table '544010396 89' 9-max Seat #3 is the button
Seat 1: stumpyn (7228 in chips) 
Seat 2: vikim08 (4693 in chips) 
Seat 3: dr.hokiday (7334 in chips) 
Seat 4: londrino (16260 in chips) 
Seat 5: You Know No (6233 in chips) 
Seat 6: Mr.Skapone (4698 in chips) 
Seat 7: 1LATESHOW1 (8704 in chips) 
Seat 8: malik_msk (28411 in chips) 
Seat 9: Ferenc35 (17688 in chips) 
stumpyn: posts the ante 60
vikim08: posts the ante 60
dr.hokiday: posts the ante 60
londrino: posts the ante 60
You Know No: posts the ante 60
Mr.Skapone: posts the ante 60
1LATESHOW1: posts the ante 60
malik_msk: posts the ante 60
Ferenc35: posts the ante 60
londrino: posts small blind 250
You Know No: posts big blind 500
*** HOLE CARDS ***
Dealt to malik_msk [Qc Qs]
Mr.Skapone: folds 
1LATESHOW1: folds 
malik_msk: raises 1000 to 1500
Ferenc35: folds 
stumpyn: folds 
vikim08: folds 
dr.hokiday: raises 5774 to 7274 and is all-in
londrino: folds 
You Know No: folds 
malik_msk: calls 5774
*** FLOP *** [5s 2s 6c]
*** TURN *** [5s 2s 6c] [Qh]
*** RIVER *** [5s 2s 6c Qh] [Td]
*** SHOW DOWN ***
malik_msk: shows [Qc Qs] (three of a kind, Queens)
dr.hokiday: shows [Ks Ac] (high card Ace)
malik_msk collected 15838 from pot
dr.hokiday finished the tournament in 647th place
*** SUMMARY ***
Total pot 15838 | Rake 0 
Board [5s 2s 6c Qh Td]
Seat 1: stumpyn folded before Flop (didn't bet)
Seat 2: vikim08 folded before Flop (didn't bet)
Seat 3: dr.hokiday (button) showed [Ks Ac] and lost with high card Ace
Seat 4: londrino (small blind) folded before Flop
Seat 5: You Know No (big blind) folded before Flop
Seat 6: Mr.Skapone folded before Flop (didn't bet)
Seat 7: 1LATESHOW1 folded before Flop (didn't bet)
Seat 8: malik_msk showed [Qc Qs] and won (15838) with three of a kind, Queens
Seat 9: Ferenc35 folded before Flop (didn't bet)



PokerStars Game #69711594543: Tournament #544010396, $20+$2 USD Hold'em No Limit - Level XIV (250/500) - 2011/10/29 22:31:11 MSK [2011/10/29 14:31:11 ET]
Table '544010396 89' 9-max Seat #4 is the button
Seat 1: stumpyn (7168 in chips) 
Seat 2: vikim08 (4633 in chips) 
Seat 4: londrino (15950 in chips) 
Seat 5: You Know No (5673 in chips) 
Seat 6: Mr.Skapone (4638 in chips) 
Seat 7: 1LATESHOW1 (8644 in chips) 
Seat 8: malik_msk (36915 in chips) 
Seat 9: Ferenc35 (17628 in chips) 
stumpyn: posts the ante 60
vikim08: posts the ante 60
londrino: posts the ante 60
You Know No: posts the ante 60
Mr.Skapone: posts the ante 60
1LATESHOW1: posts the ante 60
malik_msk: posts the ante 60
Ferenc35: posts the ante 60
You Know No: posts small blind 250
Mr.Skapone: posts big blind 500
*** HOLE CARDS ***
Dealt to malik_msk [Ad Ah]
1LATESHOW1: folds 
malik_msk: raises 1000 to 1500
Ferenc35: folds 
stumpyn: folds 
heuler27 is connected 
vikim08: folds 
londrino: folds 
You Know No: folds 
Mr.Skapone: folds 
Uncalled bet (1000) returned to malik_msk
malik_msk collected 1730 from pot
malik_msk: doesn't show hand 
*** SUMMARY ***
Total pot 1730 | Rake 0 
Seat 1: stumpyn folded before Flop (didn't bet)
Seat 2: vikim08 folded before Flop (didn't bet)
Seat 4: londrino (button) folded before Flop (didn't bet)
Seat 5: You Know No (small blind) folded before Flop
Seat 6: Mr.Skapone (big blind) folded before Flop
Seat 7: 1LATESHOW1 folded before Flop (didn't bet)
Seat 8: malik_msk collected (1730)
Seat 9: Ferenc35 folded before Flop (didn't bet)



PokerStars Game #69711638386: Tournament #544010396, $20+$2 USD Hold'em No Limit - Level XIV (250/500) - 2011/10/29 22:31:57 MSK [2011/10/29 14:31:57 ET]
Table '544010396 89' 9-max Seat #5 is the button
Seat 1: stumpyn (7108 in chips) 
Seat 2: vikim08 (4573 in chips) 
Seat 3: heuler27 (42182 in chips) 
Seat 4: londrino (15890 in chips) 
Seat 5: You Know No (5363 in chips) 
Seat 6: Mr.Skapone (4078 in chips) 
Seat 7: 1LATESHOW1 (8584 in chips) 
Seat 8: malik_msk (38085 in chips) 
Seat 9: Ferenc35 (17568 in chips) 
stumpyn: posts the ante 60
vikim08: posts the ante 60
heuler27: posts the ante 60
londrino: posts the ante 60
You Know No: posts the ante 60
Mr.Skapone: posts the ante 60
1LATESHOW1: posts the ante 60
malik_msk: posts the ante 60
Ferenc35: posts the ante 60
Mr.Skapone: posts small blind 250
1LATESHOW1: posts big blind 500
*** HOLE CARDS ***
Dealt to malik_msk [Ah Ts]
malik_msk: folds 
Ferenc35: folds 
stumpyn: folds 
vikim08: folds 
heuler27: raises 1000 to 1500
londrino: folds 
You Know No: folds 
Mr.Skapone: folds 
1LATESHOW1: folds 
Uncalled bet (1000) returned to heuler27
heuler27 collected 1790 from pot
heuler27: doesn't show hand 
*** SUMMARY ***
Total pot 1790 | Rake 0 
Seat 1: stumpyn folded before Flop (didn't bet)
Seat 2: vikim08 folded before Flop (didn't bet)
Seat 3: heuler27 collected (1790)
Seat 4: londrino folded before Flop (didn't bet)
Seat 5: You Know No (button) folded before Flop (didn't bet)
Seat 6: Mr.Skapone (small blind) folded before Flop
Seat 7: 1LATESHOW1 (big blind) folded before Flop
Seat 8: malik_msk folded before Flop (didn't bet)
Seat 9: Ferenc35 folded before Flop (didn't bet)



PokerStars Game #69711678687: Tournament #544010396, $20+$2 USD Hold'em No Limit - Level XIV (250/500) - 2011/10/29 22:32:40 MSK [2011/10/29 14:32:40 ET]
Table '544010396 89' 9-max Seat #6 is the button
Seat 1: stumpyn (7048 in chips) 
Seat 2: vikim08 (4513 in chips) 
Seat 3: heuler27 (43412 in chips) 
Seat 4: londrino (15830 in chips) 
Seat 5: You Know No (5303 in chips) 
Seat 6: Mr.Skapone (3768 in chips) 
Seat 7: 1LATESHOW1 (8024 in chips) 
Seat 8: malik_msk (38025 in chips) 
Seat 9: Ferenc35 (17508 in chips) 
stumpyn: posts the ante 60
vikim08: posts the ante 60
heuler27: posts the ante 60
londrino: posts the ante 60
You Know No: posts the ante 60
Mr.Skapone: posts the ante 60
1LATESHOW1: posts the ante 60
malik_msk: posts the ante 60
Ferenc35: posts the ante 60
1LATESHOW1: posts small blind 250
malik_msk: posts big blind 500
*** HOLE CARDS ***
Dealt to malik_msk [8d Qc]
Ferenc35: folds 
stumpyn: folds 
vikim08: folds 
heuler27: folds 
londrino: folds 
You Know No: folds 
Mr.Skapone: folds 
1LATESHOW1: folds 
Uncalled bet (250) returned to malik_msk
malik_msk collected 1040 from pot
malik_msk: doesn't show hand 
*** SUMMARY ***
Total pot 1040 | Rake 0 
Seat 1: stumpyn folded before Flop (didn't bet)
Seat 2: vikim08 folded before Flop (didn't bet)
Seat 3: heuler27 folded before Flop (didn't bet)
Seat 4: londrino folded before Flop (didn't bet)
Seat 5: You Know No folded before Flop (didn't bet)
Seat 6: Mr.Skapone (button) folded before Flop (didn't bet)
Seat 7: 1LATESHOW1 (small blind) folded before Flop
Seat 8: malik_msk (big blind) collected (1040)
Seat 9: Ferenc35 folded before Flop (didn't bet)



PokerStars Game #69711709509: Tournament #544010396, $20+$2 USD Hold'em No Limit - Level XIV (250/500) - 2011/10/29 22:33:12 MSK [2011/10/29 14:33:12 ET]
Table '544010396 89' 9-max Seat #7 is the button
Seat 1: stumpyn (6988 in chips) 
Seat 2: vikim08 (4453 in chips) 
Seat 3: heuler27 (43352 in chips) 
Seat 4: londrino (15770 in chips) 
Seat 5: You Know No (5243 in chips) 
Seat 6: Mr.Skapone (3708 in chips) 
Seat 7: 1LATESHOW1 (7714 in chips) 
Seat 8: malik_msk (38755 in chips) 
Seat 9: Ferenc35 (17448 in chips) 
stumpyn: posts the ante 60
vikim08: posts the ante 60
heuler27: posts the ante 60
londrino: posts the ante 60
You Know No: posts the ante 60
Mr.Skapone: posts the ante 60
1LATESHOW1: posts the ante 60
malik_msk: posts the ante 60
Ferenc35: posts the ante 60
malik_msk: posts small blind 250
Ferenc35: posts big blind 500
*** HOLE CARDS ***
Dealt to malik_msk [Tc 2s]
stumpyn: folds 
vikim08: folds 
heuler27: folds 
londrino: folds 
You Know No: folds 
Mr.Skapone: folds 
1LATESHOW1: folds 
malik_msk: folds 
Uncalled bet (250) returned to Ferenc35
Ferenc35 collected 1040 from pot
*** SUMMARY ***
Total pot 1040 | Rake 0 
Seat 1: stumpyn folded before Flop (didn't bet)
Seat 2: vikim08 folded before Flop (didn't bet)
Seat 3: heuler27 folded before Flop (didn't bet)
Seat 4: londrino folded before Flop (didn't bet)
Seat 5: You Know No folded before Flop (didn't bet)
Seat 6: Mr.Skapone folded before Flop (didn't bet)
Seat 7: 1LATESHOW1 (button) folded before Flop (didn't bet)
Seat 8: malik_msk (small blind) folded before Flop
Seat 9: Ferenc35 (big blind) collected (1040)



PokerStars Game #69711742074: Tournament #544010396, $20+$2 USD Hold'em No Limit - Level XIV (250/500) - 2011/10/29 22:33:46 MSK [2011/10/29 14:33:46 ET]
Table '544010396 89' 9-max Seat #8 is the button
Seat 1: stumpyn (6928 in chips) 
Seat 2: vikim08 (4393 in chips) 
Seat 3: heuler27 (43292 in chips) 
Seat 4: londrino (15710 in chips) 
Seat 5: You Know No (5183 in chips) 
Seat 6: Mr.Skapone (3648 in chips) 
Seat 7: 1LATESHOW1 (7654 in chips) 
Seat 8: malik_msk (38445 in chips) 
Seat 9: Ferenc35 (18178 in chips) 
stumpyn: posts the ante 60
vikim08: posts the ante 60
heuler27: posts the ante 60
londrino: posts the ante 60
You Know No: posts the ante 60
Mr.Skapone: posts the ante 60
1LATESHOW1: posts the ante 60
malik_msk: posts the ante 60
Ferenc35: posts the ante 60
Ferenc35: posts small blind 250
stumpyn: posts big blind 500
*** HOLE CARDS ***
Dealt to malik_msk [7d Ts]
vikim08: raises 3833 to 4333 and is all-in
heuler27: folds 
londrino: folds 
You Know No: folds 
Mr.Skapone: folds 
1LATESHOW1: raises 3261 to 7594 and is all-in
malik_msk: folds 
Ferenc35: folds 
stumpyn: folds 
Uncalled bet (3261) returned to 1LATESHOW1
*** FLOP *** [2h 4s 5s]
*** TURN *** [2h 4s 5s] [6s]
*** RIVER *** [2h 4s 5s 6s] [3h]
*** SHOW DOWN ***
vikim08: shows [8c Ad] (a straight, Deuce to Six)
1LATESHOW1: shows [Qc Qh] (a straight, Deuce to Six)
vikim08 collected 4978 from pot
1LATESHOW1 collected 4978 from pot
*** SUMMARY ***
Total pot 9956 | Rake 0 
Board [2h 4s 5s 6s 3h]
Seat 1: stumpyn (big blind) folded before Flop
Seat 2: vikim08 showed [8c Ad] and won (4978) with a straight, Deuce to Six
Seat 3: heuler27 folded before Flop (didn't bet)
Seat 4: londrino folded before Flop (didn't bet)
Seat 5: You Know No folded before Flop (didn't bet)
Seat 6: Mr.Skapone folded before Flop (didn't bet)
Seat 7: 1LATESHOW1 showed [Qc Qh] and won (4978) with a straight, Deuce to Six
Seat 8: malik_msk (button) folded before Flop (didn't bet)
Seat 9: Ferenc35 (small blind) folded before Flop



PokerStars Game #69711791410: Tournament #544010396, $20+$2 USD Hold'em No Limit - Level XV (300/600) - 2011/10/29 22:34:38 MSK [2011/10/29 14:34:38 ET]
Table '544010396 89' 9-max Seat #9 is the button
Seat 1: stumpyn (6368 in chips) 
Seat 2: vikim08 (4978 in chips) 
Seat 3: heuler27 (43232 in chips) 
Seat 4: londrino (15650 in chips) 
Seat 5: You Know No (5123 in chips) 
Seat 6: Mr.Skapone (3588 in chips) 
Seat 7: 1LATESHOW1 (8239 in chips) 
Seat 8: malik_msk (38385 in chips) 
Seat 9: Ferenc35 (17868 in chips) 
stumpyn: posts the ante 70
vikim08: posts the ante 70
heuler27: posts the ante 70
londrino: posts the ante 70
You Know No: posts the ante 70
Mr.Skapone: posts the ante 70
1LATESHOW1: posts the ante 70
malik_msk: posts the ante 70
Ferenc35: posts the ante 70
stumpyn: posts small blind 300
vikim08: posts big blind 600
*** HOLE CARDS ***
Dealt to malik_msk [2s Jd]
heuler27: folds 
londrino: folds 
You Know No: folds 
Mr.Skapone: folds 
1LATESHOW1: folds 
malik_msk: folds 
Ferenc35: folds 
stumpyn: raises 5698 to 6298 and is all-in
vikim08: folds 
Uncalled bet (5698) returned to stumpyn
stumpyn collected 1830 from pot
*** SUMMARY ***
Total pot 1830 | Rake 0 
Seat 1: stumpyn (small blind) collected (1830)
Seat 2: vikim08 (big blind) folded before Flop
Seat 3: heuler27 folded before Flop (didn't bet)
Seat 4: londrino folded before Flop (didn't bet)
Seat 5: You Know No folded before Flop (didn't bet)
Seat 6: Mr.Skapone folded before Flop (didn't bet)
Seat 7: 1LATESHOW1 folded before Flop (didn't bet)
Seat 8: malik_msk folded before Flop (didn't bet)
Seat 9: Ferenc35 (button) folded before Flop (didn't bet)



PokerStars Game #69711832531: Tournament #544010396, $20+$2 USD Hold'em No Limit - Level XV (300/600) - 2011/10/29 22:35:21 MSK [2011/10/29 14:35:21 ET]
Table '544010396 89' 9-max Seat #1 is the button
Seat 1: stumpyn (7528 in chips) 
Seat 2: vikim08 (4308 in chips) 
Seat 3: heuler27 (43162 in chips) 
Seat 4: londrino (15580 in chips) 
Seat 5: You Know No (5053 in chips) 
Seat 6: Mr.Skapone (3518 in chips) 
Seat 7: 1LATESHOW1 (8169 in chips) 
Seat 8: malik_msk (38315 in chips) 
Seat 9: Ferenc35 (17798 in chips) 
stumpyn: posts the ante 70
vikim08: posts the ante 70
heuler27: posts the ante 70
londrino: posts the ante 70
You Know No: posts the ante 70
Mr.Skapone: posts the ante 70
1LATESHOW1: posts the ante 70
malik_msk: posts the ante 70
Ferenc35: posts the ante 70
vikim08: posts small blind 300
heuler27: posts big blind 600
*** HOLE CARDS ***
Dealt to malik_msk [9h Ts]
londrino: folds 
You Know No: folds 
Mr.Skapone: folds 
1LATESHOW1: folds 
malik_msk: calls 600
Ferenc35: folds 
stumpyn: folds 
vikim08: folds 
heuler27: checks 
*** FLOP *** [2c Kh 5d]
heuler27: bets 1200
malik_msk: folds 
Uncalled bet (1200) returned to heuler27
heuler27 collected 2130 from pot
heuler27: doesn't show hand 
*** SUMMARY ***
Total pot 2130 | Rake 0 
Board [2c Kh 5d]
Seat 1: stumpyn (button) folded before Flop (didn't bet)
Seat 2: vikim08 (small blind) folded before Flop
Seat 3: heuler27 (big blind) collected (2130)
Seat 4: londrino folded before Flop (didn't bet)
Seat 5: You Know No folded before Flop (didn't bet)
Seat 6: Mr.Skapone folded before Flop (didn't bet)
Seat 7: 1LATESHOW1 folded before Flop (didn't bet)
Seat 8: malik_msk folded on the Flop
Seat 9: Ferenc35 folded before Flop (didn't bet)



PokerStars Game #69711880644: Tournament #544010396, $20+$2 USD Hold'em No Limit - Level XV (300/600) - 2011/10/29 22:36:12 MSK [2011/10/29 14:36:12 ET]
Table '544010396 89' 9-max Seat #2 is the button
Seat 1: stumpyn (7458 in chips) 
Seat 2: vikim08 (3938 in chips) 
Seat 3: heuler27 (44622 in chips) 
Seat 4: londrino (15510 in chips) 
Seat 5: You Know No (4983 in chips) 
Seat 6: Mr.Skapone (3448 in chips) 
Seat 7: 1LATESHOW1 (8099 in chips) 
Seat 8: malik_msk (37645 in chips) 
Seat 9: Ferenc35 (17728 in chips) 
stumpyn: posts the ante 70
vikim08: posts the ante 70
heuler27: posts the ante 70
londrino: posts the ante 70
You Know No: posts the ante 70
Mr.Skapone: posts the ante 70
1LATESHOW1: posts the ante 70
malik_msk: posts the ante 70
Ferenc35: posts the ante 70
heuler27: posts small blind 300
londrino: posts big blind 600
*** HOLE CARDS ***
Dealt to malik_msk [Qd Kd]
You Know No: folds 
Mr.Skapone: folds 
1LATESHOW1: folds 
malik_msk: raises 1200 to 1800
Ferenc35: folds 
stumpyn: folds 
vikim08: folds 
heuler27: folds 
londrino: raises 13640 to 15440 and is all-in
malik_msk: calls 13640
*** FLOP *** [3d 4s 9c]
*** TURN *** [3d 4s 9c] [3h]
*** RIVER *** [3d 4s 9c 3h] [9s]
*** SHOW DOWN ***
londrino: shows [8s 8c] (two pair, Nines and Eights)
malik_msk: shows [Qd Kd] (two pair, Nines and Threes)
londrino collected 31810 from pot
*** SUMMARY ***
Total pot 31810 | Rake 0 
Board [3d 4s 9c 3h 9s]
Seat 1: stumpyn folded before Flop (didn't bet)
Seat 2: vikim08 (button) folded before Flop (didn't bet)
Seat 3: heuler27 (small blind) folded before Flop
Seat 4: londrino (big blind) showed [8s 8c] and won (31810) with two pair, Nines and Eights
Seat 5: You Know No folded before Flop (didn't bet)
Seat 6: Mr.Skapone folded before Flop (didn't bet)
Seat 7: 1LATESHOW1 folded before Flop (didn't bet)
Seat 8: malik_msk showed [Qd Kd] and lost with two pair, Nines and Threes
Seat 9: Ferenc35 folded before Flop (didn't bet)



PokerStars Game #69711935622: Tournament #544010396, $20+$2 USD Hold'em No Limit - Level XV (300/600) - 2011/10/29 22:37:10 MSK [2011/10/29 14:37:10 ET]
Table '544010396 89' 9-max Seat #3 is the button
Seat 1: stumpyn (7388 in chips) 
Seat 2: vikim08 (3868 in chips) 
Seat 3: heuler27 (44252 in chips) 
Seat 4: londrino (31810 in chips) 
Seat 5: You Know No (4913 in chips) 
Seat 6: Mr.Skapone (3378 in chips) 
Seat 7: 1LATESHOW1 (8029 in chips) 
Seat 8: malik_msk (22135 in chips) 
Seat 9: Ferenc35 (17658 in chips) 
stumpyn: posts the ante 70
vikim08: posts the ante 70
heuler27: posts the ante 70
londrino: posts the ante 70
You Know No: posts the ante 70
Mr.Skapone: posts the ante 70
1LATESHOW1: posts the ante 70
malik_msk: posts the ante 70
Ferenc35: posts the ante 70
londrino: posts small blind 300
You Know No: posts big blind 600
*** HOLE CARDS ***
Dealt to malik_msk [7d Qc]
Mr.Skapone: raises 600 to 1200
1LATESHOW1: folds 
malik_msk: folds 
Ferenc35: folds 
stumpyn: folds 
vikim08: folds 
heuler27: calls 1200
londrino: folds 
You Know No: calls 600
*** FLOP *** [8d 3d 6c]
You Know No: checks 
Mr.Skapone: bets 2108 and is all-in
heuler27: calls 2108
You Know No: folds 
*** TURN *** [8d 3d 6c] [2c]
*** RIVER *** [8d 3d 6c 2c] [9h]
*** SHOW DOWN ***
Mr.Skapone: shows [8s Ad] (a pair of Eights)
heuler27: shows [Qd 5d] (high card Queen)
Mr.Skapone collected 8746 from pot
*** SUMMARY ***
Total pot 8746 | Rake 0 
Board [8d 3d 6c 2c 9h]
Seat 1: stumpyn folded before Flop (didn't bet)
Seat 2: vikim08 folded before Flop (didn't bet)
Seat 3: heuler27 (button) showed [Qd 5d] and lost with high card Queen
Seat 4: londrino (small blind) folded before Flop
Seat 5: You Know No (big blind) folded on the Flop
Seat 6: Mr.Skapone showed [8s Ad] and won (8746) with a pair of Eights
Seat 7: 1LATESHOW1 folded before Flop (didn't bet)
Seat 8: malik_msk folded before Flop (didn't bet)
Seat 9: Ferenc35 folded before Flop (didn't bet)



PokerStars Game #69711985874: Tournament #544010396, $20+$2 USD Hold'em No Limit - Level XV (300/600) - 2011/10/29 22:38:03 MSK [2011/10/29 14:38:03 ET]
Table '544010396 89' 9-max Seat #4 is the button
Seat 1: stumpyn (7318 in chips) 
Seat 2: vikim08 (3798 in chips) 
Seat 3: heuler27 (40874 in chips) 
Seat 4: londrino (31440 in chips) 
Seat 5: You Know No (3643 in chips) 
Seat 6: Mr.Skapone (8746 in chips) 
Seat 7: 1LATESHOW1 (7959 in chips) 
Seat 8: malik_msk (22065 in chips) 
Seat 9: Ferenc35 (17588 in chips) 
stumpyn: posts the ante 70
vikim08: posts the ante 70
heuler27: posts the ante 70
londrino: posts the ante 70
You Know No: posts the ante 70
Mr.Skapone: posts the ante 70
1LATESHOW1: posts the ante 70
malik_msk: posts the ante 70
Ferenc35: posts the ante 70
You Know No: posts small blind 300
Mr.Skapone: posts big blind 600
*** HOLE CARDS ***
Dealt to malik_msk [6c Ad]
1LATESHOW1: folds 
malik_msk: calls 600
Ferenc35: raises 1200 to 1800
stumpyn: folds 
vikim08: folds 
heuler27: folds 
londrino: raises 29570 to 31370 and is all-in
You Know No: folds 
Mr.Skapone: folds 
malik_msk: folds 
Ferenc35: calls 15718 and is all-in
Uncalled bet (13852) returned to londrino
*** FLOP *** [6s 7h Jh]
*** TURN *** [6s 7h Jh] [Kh]
*** RIVER *** [6s 7h Jh Kh] [As]
*** SHOW DOWN ***
Ferenc35: shows [9s 9h] (a pair of Nines)
londrino: shows [Kd Ks] (three of a kind, Kings)
londrino collected 37166 from pot
Ferenc35 finished the tournament in 553rd place
*** SUMMARY ***
Total pot 37166 | Rake 0 
Board [6s 7h Jh Kh As]
Seat 1: stumpyn folded before Flop (didn't bet)
Seat 2: vikim08 folded before Flop (didn't bet)
Seat 3: heuler27 folded before Flop (didn't bet)
Seat 4: londrino (button) showed [Kd Ks] and won (37166) with three of a kind, Kings
Seat 5: You Know No (small blind) folded before Flop
Seat 6: Mr.Skapone (big blind) folded before Flop
Seat 7: 1LATESHOW1 folded before Flop (didn't bet)
Seat 8: malik_msk folded before Flop
Seat 9: Ferenc35 showed [9s 9h] and lost with a pair of Nines



PokerStars Game #69712056785: Tournament #544010396, $20+$2 USD Hold'em No Limit - Level XV (300/600) - 2011/10/29 22:39:18 MSK [2011/10/29 14:39:18 ET]
Table '544010396 89' 9-max Seat #5 is the button
Seat 1: stumpyn (7248 in chips) 
Seat 2: vikim08 (3728 in chips) 
Seat 3: heuler27 (40804 in chips) 
Seat 4: londrino (51018 in chips) 
Seat 5: You Know No (3273 in chips) 
Seat 6: Mr.Skapone (8076 in chips) 
Seat 7: 1LATESHOW1 (7889 in chips) 
Seat 8: malik_msk (21395 in chips) 
stumpyn: posts the ante 70
vikim08: posts the ante 70
heuler27: posts the ante 70
londrino: posts the ante 70
You Know No: posts the ante 70
Mr.Skapone: posts the ante 70
1LATESHOW1: posts the ante 70
malik_msk: posts the ante 70
Mr.Skapone: posts small blind 300
1LATESHOW1: posts big blind 600
*** HOLE CARDS ***
Dealt to malik_msk [7d 5c]
malik_msk: folds 
stumpyn: folds 
vikim08: folds 
heuler27: folds 
londrino: folds 
You Know No: folds 
Mr.Skapone: folds 
Uncalled bet (300) returned to 1LATESHOW1
1LATESHOW1 collected 1160 from pot
*** SUMMARY ***
Total pot 1160 | Rake 0 
Seat 1: stumpyn folded before Flop (didn't bet)
Seat 2: vikim08 folded before Flop (didn't bet)
Seat 3: heuler27 folded before Flop (didn't bet)
Seat 4: londrino folded before Flop (didn't bet)
Seat 5: You Know No (button) folded before Flop (didn't bet)
Seat 6: Mr.Skapone (small blind) folded before Flop
Seat 7: 1LATESHOW1 (big blind) collected (1160)
Seat 8: malik_msk folded before Flop (didn't bet)



PokerStars Game #69712096156: Tournament #544010396, $20+$2 USD Hold'em No Limit - Level XV (300/600) - 2011/10/29 22:40:00 MSK [2011/10/29 14:40:00 ET]
Table '544010396 89' 9-max Seat #6 is the button
Seat 1: stumpyn (7178 in chips) 
Seat 2: vikim08 (3658 in chips) 
Seat 3: heuler27 (40734 in chips) 
Seat 4: londrino (50948 in chips) 
Seat 5: You Know No (3203 in chips) 
Seat 6: Mr.Skapone (7706 in chips) 
Seat 7: 1LATESHOW1 (8679 in chips) 
Seat 8: malik_msk (21325 in chips) 
Seat 9: justcallme76 (16569 in chips) is sitting out
stumpyn: posts the ante 70
vikim08: posts the ante 70
heuler27: posts the ante 70
londrino: posts the ante 70
You Know No: posts the ante 70
Mr.Skapone: posts the ante 70
1LATESHOW1: posts the ante 70
malik_msk: posts the ante 70
justcallme76: posts the ante 70
1LATESHOW1: posts small blind 300
malik_msk: posts big blind 600
*** HOLE CARDS ***
Dealt to malik_msk [8c 7d]
justcallme76: folds 
stumpyn: raises 6508 to 7108 and is all-in
vikim08: calls 3588 and is all-in
heuler27: folds 
justcallme76 is connected 
londrino: raises 43770 to 50878 and is all-in
You Know No: folds 
Mr.Skapone: folds 
justcallme76 has returned
1LATESHOW1: folds 
malik_msk: folds 
Uncalled bet (43770) returned to londrino
*** FLOP *** [Qc Jc Qd]
*** TURN *** [Qc Jc Qd] [2c]
*** RIVER *** [Qc Jc Qd 2c] [7s]
*** SHOW DOWN ***
stumpyn: shows [Ad Kh] (a pair of Queens)
londrino: shows [8d 8s] (two pair, Queens and Eights)
londrino collected 7040 from side pot
vikim08: shows [9h 9d] (two pair, Queens and Nines)
vikim08 collected 12294 from main pot
stumpyn finished the tournament in 539th place
*** SUMMARY ***
Total pot 19334 Main pot 12294. Side pot 7040. | Rake 0 
Board [Qc Jc Qd 2c 7s]
Seat 1: stumpyn showed [Ad Kh] and lost with a pair of Queens
Seat 2: vikim08 showed [9h 9d] and won (12294) with two pair, Queens and Nines
Seat 3: heuler27 folded before Flop (didn't bet)
Seat 4: londrino showed [8d 8s] and won (7040) with two pair, Queens and Eights
Seat 5: You Know No folded before Flop (didn't bet)
Seat 6: Mr.Skapone (button) folded before Flop (didn't bet)
Seat 7: 1LATESHOW1 (small blind) folded before Flop
Seat 8: malik_msk (big blind) folded before Flop
Seat 9: justcallme76 folded before Flop (didn't bet)



PokerStars Game #69712135188: Tournament #544010396, $20+$2 USD Hold'em No Limit - Level XV (300/600) - 2011/10/29 22:40:42 MSK [2011/10/29 14:40:42 ET]
Table '544010396 89' 9-max Seat #7 is the button
Seat 2: vikim08 (12294 in chips) 
Seat 3: heuler27 (40664 in chips) 
Seat 4: londrino (50810 in chips) 
Seat 5: You Know No (3133 in chips) 
Seat 6: Mr.Skapone (7636 in chips) 
Seat 7: 1LATESHOW1 (8309 in chips) 
Seat 8: malik_msk (20655 in chips) 
Seat 9: justcallme76 (16499 in chips) 
vikim08: posts the ante 70
heuler27: posts the ante 70
londrino: posts the ante 70
You Know No: posts the ante 70
Mr.Skapone: posts the ante 70
1LATESHOW1: posts the ante 70
malik_msk: posts the ante 70
justcallme76: posts the ante 70
malik_msk: posts small blind 300
justcallme76: posts big blind 600
*** HOLE CARDS ***
Dealt to malik_msk [Ac Qc]
vikim08: folds 
heuler27: folds 
londrino: folds 
You Know No: raises 2463 to 3063 and is all-in
Mr.Skapone: folds 
1LATESHOW1: folds 
malik_msk: raises 2463 to 5526
justcallme76 has timed out while being disconnected
justcallme76: folds 
Uncalled bet (2463) returned to malik_msk
justcallme76 is sitting out
*** FLOP *** [2h 8c Ts]
*** TURN *** [2h 8c Ts] [9c]
*** RIVER *** [2h 8c Ts 9c] [Kc]
*** SHOW DOWN ***
malik_msk: shows [Ac Qc] (a flush, Ace high)
You Know No: shows [4d 4h] (a pair of Fours)
malik_msk collected 7286 from pot
You Know No finished the tournament in 533rd place
Exit Shikari is connected 
*** SUMMARY ***
Total pot 7286 | Rake 0 
Board [2h 8c Ts 9c Kc]
Seat 2: vikim08 folded before Flop (didn't bet)
Seat 3: heuler27 folded before Flop (didn't bet)
Seat 4: londrino folded before Flop (didn't bet)
Seat 5: You Know No showed [4d 4h] and lost with a pair of Fours
Seat 6: Mr.Skapone folded before Flop (didn't bet)
Seat 7: 1LATESHOW1 (button) folded before Flop (didn't bet)
Seat 8: malik_msk (small blind) showed [Ac Qc] and won (7286) with a flush, Ace high
Seat 9: justcallme76 (big blind) folded before Flop



PokerStars Game #69712204210: Tournament #544010396, $20+$2 USD Hold'em No Limit - Level XV (300/600) - 2011/10/29 22:41:55 MSK [2011/10/29 14:41:55 ET]
Table '544010396 89' 9-max Seat #8 is the button
Seat 1: Gismo&Merlin (19644 in chips) 
Seat 2: vikim08 (12224 in chips) 
Seat 3: heuler27 (40594 in chips) 
Seat 4: londrino (50740 in chips) 
Seat 5: Exit Shikari (32450 in chips) 
Seat 6: Mr.Skapone (7566 in chips) 
Seat 7: 1LATESHOW1 (8239 in chips) 
Seat 8: malik_msk (24808 in chips) 
Seat 9: justcallme76 (15829 in chips) is sitting out
Gismo&Merlin: posts the ante 70
vikim08: posts the ante 70
heuler27: posts the ante 70
londrino: posts the ante 70
Exit Shikari: posts the ante 70
Mr.Skapone: posts the ante 70
1LATESHOW1: posts the ante 70
malik_msk: posts the ante 70
justcallme76: posts the ante 70
justcallme76: posts small blind 300
Gismo&Merlin: posts big blind 600
*** HOLE CARDS ***
Dealt to malik_msk [9h 7s]
vikim08: folds 
justcallme76 is disconnected 
heuler27: folds 
londrino: folds 
Exit Shikari: folds 
Mr.Skapone: folds 
justcallme76 is connected 
1LATESHOW1: folds 
malik_msk: calls 600
justcallme76: folds 
justcallme76 has returned
Gismo&Merlin: checks 
*** FLOP *** [3c Kh Qd]
Gismo&Merlin: checks 
malik_msk: bets 1200
Gismo&Merlin: folds 
Uncalled bet (1200) returned to malik_msk
malik_msk collected 2130 from pot
malik_msk: doesn't show hand 
*** SUMMARY ***
Total pot 2130 | Rake 0 
Board [3c Kh Qd]
Seat 1: Gismo&Merlin (big blind) folded on the Flop
Seat 2: vikim08 folded before Flop (didn't bet)
Seat 3: heuler27 folded before Flop (didn't bet)
Seat 4: londrino folded before Flop (didn't bet)
Seat 5: Exit Shikari folded before Flop (didn't bet)
Seat 6: Mr.Skapone folded before Flop (didn't bet)
Seat 7: 1LATESHOW1 folded before Flop (didn't bet)
Seat 8: malik_msk (button) collected (2130)
Seat 9: justcallme76 (small blind) folded before Flop



PokerStars Game #69712246952: Tournament #544010396, $20+$2 USD Hold'em No Limit - Level XV (300/600) - 2011/10/29 22:42:40 MSK [2011/10/29 14:42:40 ET]
Table '544010396 89' 9-max Seat #9 is the button
Seat 1: Gismo&Merlin (18974 in chips) 
Seat 2: vikim08 (12154 in chips) 
Seat 3: heuler27 (40524 in chips) 
Seat 4: londrino (50670 in chips) 
Seat 5: Exit Shikari (32380 in chips) 
Seat 6: Mr.Skapone (7496 in chips) 
Seat 7: 1LATESHOW1 (8169 in chips) 
Seat 8: malik_msk (26268 in chips) 
Seat 9: justcallme76 (15459 in chips) 
Gismo&Merlin: posts the ante 70
vikim08: posts the ante 70
heuler27: posts the ante 70
londrino: posts the ante 70
Exit Shikari: posts the ante 70
Mr.Skapone: posts the ante 70
1LATESHOW1: posts the ante 70
malik_msk: posts the ante 70
justcallme76: posts the ante 70
Gismo&Merlin: posts small blind 300
vikim08: posts big blind 600
*** HOLE CARDS ***
Dealt to malik_msk [8h 7c]
heuler27: folds 
londrino: folds 
Exit Shikari: folds 
Mr.Skapone: folds 
1LATESHOW1: folds 
malik_msk: folds 
justcallme76: raises 1200 to 1800
Gismo&Merlin: folds 
vikim08: folds 
Uncalled bet (1200) returned to justcallme76
justcallme76 collected 2130 from pot
*** SUMMARY ***
Total pot 2130 | Rake 0 
Seat 1: Gismo&Merlin (small blind) folded before Flop
Seat 2: vikim08 (big blind) folded before Flop
Seat 3: heuler27 folded before Flop (didn't bet)
Seat 4: londrino folded before Flop (didn't bet)
Seat 5: Exit Shikari folded before Flop (didn't bet)
Seat 6: Mr.Skapone folded before Flop (didn't bet)
Seat 7: 1LATESHOW1 folded before Flop (didn't bet)
Seat 8: malik_msk folded before Flop (didn't bet)
Seat 9: justcallme76 (button) collected (2130)



PokerStars Game #69712302304: Tournament #544010396, $20+$2 USD Hold'em No Limit - Level XV (300/600) - 2011/10/29 22:43:38 MSK [2011/10/29 14:43:38 ET]
Table '544010396 89' 9-max Seat #1 is the button
Seat 1: Gismo&Merlin (18604 in chips) 
Seat 2: vikim08 (11484 in chips) 
Seat 3: heuler27 (40454 in chips) 
Seat 4: londrino (50600 in chips) 
Seat 5: Exit Shikari (32310 in chips) 
Seat 6: Mr.Skapone (7426 in chips) 
Seat 7: 1LATESHOW1 (8099 in chips) 
Seat 8: malik_msk (26198 in chips) 
Seat 9: justcallme76 (16919 in chips) 
Gismo&Merlin: posts the ante 70
vikim08: posts the ante 70
heuler27: posts the ante 70
londrino: posts the ante 70
Exit Shikari: posts the ante 70
Mr.Skapone: posts the ante 70
1LATESHOW1: posts the ante 70
malik_msk: posts the ante 70
justcallme76: posts the ante 70
vikim08: posts small blind 300
heuler27: posts big blind 600
*** HOLE CARDS ***
Dealt to malik_msk [3s Tc]
londrino: folds 
Exit Shikari: folds 
Mr.Skapone: folds 
1LATESHOW1: folds 
malik_msk: folds 
justcallme76: folds 
Gismo&Merlin: folds 
vikim08 has timed out
vikim08: folds 
Uncalled bet (300) returned to heuler27
vikim08 is sitting out
heuler27 collected 1230 from pot
heuler27: doesn't show hand 
vikim08 has returned
*** SUMMARY ***
Total pot 1230 | Rake 0 
Seat 1: Gismo&Merlin (button) folded before Flop (didn't bet)
Seat 2: vikim08 (small blind) folded before Flop
Seat 3: heuler27 (big blind) collected (1230)
Seat 4: londrino folded before Flop (didn't bet)
Seat 5: Exit Shikari folded before Flop (didn't bet)
Seat 6: Mr.Skapone folded before Flop (didn't bet)
Seat 7: 1LATESHOW1 folded before Flop (didn't bet)
Seat 8: malik_msk folded before Flop (didn't bet)
Seat 9: justcallme76 folded before Flop (didn't bet)



PokerStars Game #69712349290: Tournament #544010396, $20+$2 USD Hold'em No Limit - Level XVI (350/700) - 2011/10/29 22:44:28 MSK [2011/10/29 14:44:28 ET]
Table '544010396 89' 9-max Seat #2 is the button
Seat 1: Gismo&Merlin (18534 in chips) 
Seat 2: vikim08 (11114 in chips) 
Seat 3: heuler27 (41314 in chips) 
Seat 4: londrino (50530 in chips) 
Seat 5: Exit Shikari (32240 in chips) 
Seat 6: Mr.Skapone (7356 in chips) 
Seat 7: 1LATESHOW1 (8029 in chips) 
Seat 8: malik_msk (26128 in chips) 
Seat 9: justcallme76 (16849 in chips) 
Gismo&Merlin: posts the ante 85
vikim08: posts the ante 85
heuler27: posts the ante 85
londrino: posts the ante 85
Exit Shikari: posts the ante 85
Mr.Skapone: posts the ante 85
1LATESHOW1: posts the ante 85
malik_msk: posts the ante 85
justcallme76: posts the ante 85
heuler27: posts small blind 350
londrino: posts big blind 700
*** HOLE CARDS ***
Dealt to malik_msk [Kh 2d]
Exit Shikari: folds 
Mr.Skapone: raises 6571 to 7271 and is all-in
1LATESHOW1: folds 
malik_msk: folds 
justcallme76: folds 
Gismo&Merlin: folds 
vikim08: folds 
heuler27: folds 
londrino: folds 
Uncalled bet (6571) returned to Mr.Skapone
Mr.Skapone collected 2515 from pot
*** SUMMARY ***
Total pot 2515 | Rake 0 
Seat 1: Gismo&Merlin folded before Flop (didn't bet)
Seat 2: vikim08 (button) folded before Flop (didn't bet)
Seat 3: heuler27 (small blind) folded before Flop
Seat 4: londrino (big blind) folded before Flop
Seat 5: Exit Shikari folded before Flop (didn't bet)
Seat 6: Mr.Skapone collected (2515)
Seat 7: 1LATESHOW1 folded before Flop (didn't bet)
Seat 8: malik_msk folded before Flop (didn't bet)
Seat 9: justcallme76 folded before Flop (didn't bet)



PokerStars Game #69712392806: Tournament #544010396, $20+$2 USD Hold'em No Limit - Level XVI (350/700) - 2011/10/29 22:45:13 MSK [2011/10/29 14:45:13 ET]
Table '544010396 89' 9-max Seat #3 is the button
Seat 1: Gismo&Merlin (18449 in chips) 
Seat 2: vikim08 (11029 in chips) 
Seat 3: heuler27 (40879 in chips) 
Seat 4: londrino (49745 in chips) 
Seat 5: Exit Shikari (32155 in chips) 
Seat 6: Mr.Skapone (9086 in chips) 
Seat 7: 1LATESHOW1 (7944 in chips) 
Seat 8: malik_msk (26043 in chips) 
Seat 9: justcallme76 (16764 in chips) 
Gismo&Merlin: posts the ante 85
vikim08: posts the ante 85
heuler27: posts the ante 85
londrino: posts the ante 85
Exit Shikari: posts the ante 85
Mr.Skapone: posts the ante 85
1LATESHOW1: posts the ante 85
malik_msk: posts the ante 85
justcallme76: posts the ante 85
londrino: posts small blind 350
Exit Shikari: posts big blind 700
*** HOLE CARDS ***
Dealt to malik_msk [Tc Qh]
Mr.Skapone: folds 
1LATESHOW1: folds 
malik_msk: calls 700
justcallme76: folds 
Gismo&Merlin: folds 
vikim08: folds 
heuler27: calls 700
londrino: raises 2800 to 3500
Exit Shikari: folds 
malik_msk: folds 
heuler27: folds 
Uncalled bet (2800) returned to londrino
londrino collected 3565 from pot
*** SUMMARY ***
Total pot 3565 | Rake 0 
Seat 1: Gismo&Merlin folded before Flop (didn't bet)
Seat 2: vikim08 folded before Flop (didn't bet)
Seat 3: heuler27 (button) folded before Flop
Seat 4: londrino (small blind) collected (3565)
Seat 5: Exit Shikari (big blind) folded before Flop
Seat 6: Mr.Skapone folded before Flop (didn't bet)
Seat 7: 1LATESHOW1 folded before Flop (didn't bet)
Seat 8: malik_msk folded before Flop
Seat 9: justcallme76 folded before Flop (didn't bet)



PokerStars Game #69712441277: Tournament #544010396, $20+$2 USD Hold'em No Limit - Level XVI (350/700) - 2011/10/29 22:46:03 MSK [2011/10/29 14:46:03 ET]
Table '544010396 89' 9-max Seat #4 is the button
Seat 1: Gismo&Merlin (18364 in chips) 
Seat 2: vikim08 (10944 in chips) 
Seat 3: heuler27 (40094 in chips) 
Seat 4: londrino (52525 in chips) 
Seat 5: Exit Shikari (31370 in chips) 
Seat 6: Mr.Skapone (9001 in chips) 
Seat 7: 1LATESHOW1 (7859 in chips) 
Seat 8: malik_msk (25258 in chips) 
Seat 9: justcallme76 (16679 in chips) 
Gismo&Merlin: posts the ante 85
vikim08: posts the ante 85
heuler27: posts the ante 85
londrino: posts the ante 85
Exit Shikari: posts the ante 85
Mr.Skapone: posts the ante 85
1LATESHOW1: posts the ante 85
malik_msk: posts the ante 85
justcallme76: posts the ante 85
Exit Shikari: posts small blind 350
Mr.Skapone: posts big blind 700
*** HOLE CARDS ***
Dealt to malik_msk [9c 7s]
1LATESHOW1: folds 
malik_msk: folds 
justcallme76: folds 
Gismo&Merlin: folds 
vikim08: folds 
heuler27: folds 
londrino: raises 1400 to 2100
Exit Shikari: folds 
Mr.Skapone: folds 
Uncalled bet (1400) returned to londrino
londrino collected 2515 from pot
*** SUMMARY ***
Total pot 2515 | Rake 0 
Seat 1: Gismo&Merlin folded before Flop (didn't bet)
Seat 2: vikim08 folded before Flop (didn't bet)
Seat 3: heuler27 folded before Flop (didn't bet)
Seat 4: londrino (button) collected (2515)
Seat 5: Exit Shikari (small blind) folded before Flop
Seat 6: Mr.Skapone (big blind) folded before Flop
Seat 7: 1LATESHOW1 folded before Flop (didn't bet)
Seat 8: malik_msk folded before Flop (didn't bet)
Seat 9: justcallme76 folded before Flop (didn't bet)



PokerStars Game #69712482136: Tournament #544010396, $20+$2 USD Hold'em No Limit - Level XVI (350/700) - 2011/10/29 22:46:46 MSK [2011/10/29 14:46:46 ET]
Table '544010396 89' 9-max Seat #5 is the button
Seat 1: Gismo&Merlin (18279 in chips) 
Seat 2: vikim08 (10859 in chips) 
Seat 3: heuler27 (40009 in chips) 
Seat 4: londrino (54255 in chips) 
Seat 5: Exit Shikari (30935 in chips) 
Seat 6: Mr.Skapone (8216 in chips) 
Seat 7: 1LATESHOW1 (7774 in chips) 
Seat 8: malik_msk (25173 in chips) 
Seat 9: justcallme76 (16594 in chips) 
Gismo&Merlin: posts the ante 85
vikim08: posts the ante 85
heuler27: posts the ante 85
londrino: posts the ante 85
Exit Shikari: posts the ante 85
Mr.Skapone: posts the ante 85
1LATESHOW1: posts the ante 85
malik_msk: posts the ante 85
justcallme76: posts the ante 85
Mr.Skapone: posts small blind 350
1LATESHOW1: posts big blind 700
*** HOLE CARDS ***
Dealt to malik_msk [4h 5h]
justcallme76 is disconnected 
malik_msk: folds 
justcallme76 is connected 
justcallme76: folds 
Gismo&Merlin: folds 
vikim08: folds 
heuler27: folds 
londrino: raises 2100 to 2800
Exit Shikari: folds 
Mr.Skapone: folds 
1LATESHOW1: folds 
Uncalled bet (2100) returned to londrino
londrino collected 2515 from pot
*** SUMMARY ***
Total pot 2515 | Rake 0 
Seat 1: Gismo&Merlin folded before Flop (didn't bet)
Seat 2: vikim08 folded before Flop (didn't bet)
Seat 3: heuler27 folded before Flop (didn't bet)
Seat 4: londrino collected (2515)
Seat 5: Exit Shikari (button) folded before Flop (didn't bet)
Seat 6: Mr.Skapone (small blind) folded before Flop
Seat 7: 1LATESHOW1 (big blind) folded before Flop
Seat 8: malik_msk folded before Flop (didn't bet)
Seat 9: justcallme76 folded before Flop (didn't bet)



PokerStars Game #69712537592: Tournament #544010396, $20+$2 USD Hold'em No Limit - Level XVI (350/700) - 2011/10/29 22:47:44 MSK [2011/10/29 14:47:44 ET]
Table '544010396 89' 9-max Seat #6 is the button
Seat 1: Gismo&Merlin (18194 in chips) 
Seat 2: vikim08 (10774 in chips) 
Seat 3: heuler27 (39924 in chips) 
Seat 4: londrino (55985 in chips) 
Seat 5: Exit Shikari (30850 in chips) 
Seat 6: Mr.Skapone (7781 in chips) 
Seat 7: 1LATESHOW1 (6989 in chips) 
Seat 8: malik_msk (25088 in chips) 
Seat 9: justcallme76 (16509 in chips) 
Gismo&Merlin: posts the ante 85
vikim08: posts the ante 85
heuler27: posts the ante 85
londrino: posts the ante 85
Exit Shikari: posts the ante 85
Mr.Skapone: posts the ante 85
1LATESHOW1: posts the ante 85
malik_msk: posts the ante 85
justcallme76: posts the ante 85
1LATESHOW1: posts small blind 350
malik_msk: posts big blind 700
*** HOLE CARDS ***
Dealt to malik_msk [Td 7d]
justcallme76: folds 
Gismo&Merlin: folds 
vikim08: raises 899 to 1599
heuler27: folds 
londrino: folds 
Exit Shikari: folds 
Mr.Skapone: folds 
1LATESHOW1: folds 
malik_msk: calls 899
*** FLOP *** [Ad 9s 3h]
malik_msk: checks 
vikim08: bets 2800
justcallme76 is connected 
malik_msk: folds 
Uncalled bet (2800) returned to vikim08
vikim08 collected 4313 from pot
*** SUMMARY ***
Total pot 4313 | Rake 0 
Board [Ad 9s 3h]
Seat 1: Gismo&Merlin folded before Flop (didn't bet)
Seat 2: vikim08 collected (4313)
Seat 3: heuler27 folded before Flop (didn't bet)
Seat 4: londrino folded before Flop (didn't bet)
Seat 5: Exit Shikari folded before Flop (didn't bet)
Seat 6: Mr.Skapone (button) folded before Flop (didn't bet)
Seat 7: 1LATESHOW1 (small blind) folded before Flop
Seat 8: malik_msk (big blind) folded on the Flop
Seat 9: justcallme76 folded before Flop (didn't bet)



PokerStars Game #69712603683: Tournament #544010396, $20+$2 USD Hold'em No Limit - Level XVI (350/700) - 2011/10/29 22:48:53 MSK [2011/10/29 14:48:53 ET]
Table '544010396 89' 9-max Seat #7 is the button
Seat 1: Gismo&Merlin (18109 in chips) 
Seat 2: vikim08 (13403 in chips) 
Seat 3: heuler27 (39839 in chips) 
Seat 4: londrino (55900 in chips) 
Seat 5: Exit Shikari (30765 in chips) 
Seat 6: Mr.Skapone (7696 in chips) 
Seat 7: 1LATESHOW1 (6554 in chips) 
Seat 8: malik_msk (23404 in chips) 
Seat 9: justcallme76 (16424 in chips) 
Gismo&Merlin: posts the ante 85
vikim08: posts the ante 85
heuler27: posts the ante 85
londrino: posts the ante 85
Exit Shikari: posts the ante 85
Mr.Skapone: posts the ante 85
1LATESHOW1: posts the ante 85
malik_msk: posts the ante 85
justcallme76: posts the ante 85
malik_msk: posts small blind 350
justcallme76: posts big blind 700
*** HOLE CARDS ***
Dealt to malik_msk [9c 3h]
Gismo&Merlin: calls 700
vikim08: folds 
heuler27: folds 
londrino: folds 
Exit Shikari: raises 1400 to 2100
Mr.Skapone: folds 
1LATESHOW1: folds 
malik_msk: folds 
justcallme76: folds 
Gismo&Merlin: folds 
Uncalled bet (1400) returned to Exit Shikari
Exit Shikari collected 3215 from pot
Exit Shikari: doesn't show hand 
*** SUMMARY ***
Total pot 3215 | Rake 0 
Seat 1: Gismo&Merlin folded before Flop
Seat 2: vikim08 folded before Flop (didn't bet)
Seat 3: heuler27 folded before Flop (didn't bet)
Seat 4: londrino folded before Flop (didn't bet)
Seat 5: Exit Shikari collected (3215)
Seat 6: Mr.Skapone folded before Flop (didn't bet)
Seat 7: 1LATESHOW1 (button) folded before Flop (didn't bet)
Seat 8: malik_msk (small blind) folded before Flop
Seat 9: justcallme76 (big blind) folded before Flop



PokerStars Game #69712669281: Tournament #544010396, $20+$2 USD Hold'em No Limit - Level XVI (350/700) - 2011/10/29 22:50:03 MSK [2011/10/29 14:50:03 ET]
Table '544010396 89' 9-max Seat #8 is the button
Seat 1: Gismo&Merlin (17324 in chips) 
Seat 2: vikim08 (13318 in chips) 
Seat 3: heuler27 (39754 in chips) 
Seat 4: londrino (55815 in chips) 
Seat 5: Exit Shikari (33195 in chips) 
Seat 6: Mr.Skapone (7611 in chips) 
Seat 7: 1LATESHOW1 (6469 in chips) 
Seat 8: malik_msk (22969 in chips) 
Seat 9: justcallme76 (15639 in chips) 
Gismo&Merlin: posts the ante 85
vikim08: posts the ante 85
heuler27: posts the ante 85
londrino: posts the ante 85
Exit Shikari: posts the ante 85
Mr.Skapone: posts the ante 85
1LATESHOW1: posts the ante 85
malik_msk: posts the ante 85
justcallme76: posts the ante 85
justcallme76: posts small blind 350
Gismo&Merlin: posts big blind 700
*** HOLE CARDS ***
Dealt to malik_msk [Qh 3s]
vikim08: folds 
heuler27: folds 
londrino: raises 2100 to 2800
Exit Shikari: folds 
Mr.Skapone: folds 
1LATESHOW1: folds 
malik_msk: folds 
justcallme76: folds 
Gismo&Merlin: folds 
Uncalled bet (2100) returned to londrino
londrino collected 2515 from pot
*** SUMMARY ***
Total pot 2515 | Rake 0 
Seat 1: Gismo&Merlin (big blind) folded before Flop
Seat 2: vikim08 folded before Flop (didn't bet)
Seat 3: heuler27 folded before Flop (didn't bet)
Seat 4: londrino collected (2515)
Seat 5: Exit Shikari folded before Flop (didn't bet)
Seat 6: Mr.Skapone folded before Flop (didn't bet)
Seat 7: 1LATESHOW1 folded before Flop (didn't bet)
Seat 8: malik_msk (button) folded before Flop (didn't bet)
Seat 9: justcallme76 (small blind) folded before Flop



PokerStars Game #69712717430: Tournament #544010396, $20+$2 USD Hold'em No Limit - Level XVI (350/700) - 2011/10/29 22:50:54 MSK [2011/10/29 14:50:54 ET]
Table '544010396 89' 9-max Seat #9 is the button
Seat 1: Gismo&Merlin (16539 in chips) 
Seat 2: vikim08 (13233 in chips) 
Seat 3: heuler27 (39669 in chips) 
Seat 4: londrino (57545 in chips) 
Seat 5: Exit Shikari (33110 in chips) 
Seat 6: Mr.Skapone (7526 in chips) 
Seat 7: 1LATESHOW1 (6384 in chips) 
Seat 8: malik_msk (22884 in chips) 
Seat 9: justcallme76 (15204 in chips) 
Gismo&Merlin: posts the ante 85
vikim08: posts the ante 85
heuler27: posts the ante 85
londrino: posts the ante 85
Exit Shikari: posts the ante 85
Mr.Skapone: posts the ante 85
1LATESHOW1: posts the ante 85
malik_msk: posts the ante 85
justcallme76: posts the ante 85
Gismo&Merlin: posts small blind 350
vikim08: posts big blind 700
*** HOLE CARDS ***
Dealt to malik_msk [3s 6d]
heuler27: folds 
londrino: folds 
Exit Shikari: folds 
Mr.Skapone: folds 
1LATESHOW1: folds 
malik_msk: folds 
justcallme76: raises 1400 to 2100
Gismo&Merlin: folds 
vikim08: folds 
Uncalled bet (1400) returned to justcallme76
justcallme76 collected 2515 from pot
*** SUMMARY ***
Total pot 2515 | Rake 0 
Seat 1: Gismo&Merlin (small blind) folded before Flop
Seat 2: vikim08 (big blind) folded before Flop
Seat 3: heuler27 folded before Flop (didn't bet)
Seat 4: londrino folded before Flop (didn't bet)
Seat 5: Exit Shikari folded before Flop (didn't bet)
Seat 6: Mr.Skapone folded before Flop (didn't bet)
Seat 7: 1LATESHOW1 folded before Flop (didn't bet)
Seat 8: malik_msk folded before Flop (didn't bet)
Seat 9: justcallme76 (button) collected (2515)



PokerStars Game #69712751640: Tournament #544010396, $20+$2 USD Hold'em No Limit - Level XVI (350/700) - 2011/10/29 22:51:30 MSK [2011/10/29 14:51:30 ET]
Table '544010396 89' 9-max Seat #1 is the button
Seat 1: Gismo&Merlin (16104 in chips) 
Seat 2: vikim08 (12448 in chips) 
Seat 3: heuler27 (39584 in chips) 
Seat 4: londrino (57460 in chips) 
Seat 5: Exit Shikari (33025 in chips) 
Seat 6: Mr.Skapone (7441 in chips) 
Seat 7: 1LATESHOW1 (6299 in chips) 
Seat 8: malik_msk (22799 in chips) 
Seat 9: justcallme76 (16934 in chips) 
Gismo&Merlin: posts the ante 85
vikim08: posts the ante 85
heuler27: posts the ante 85
londrino: posts the ante 85
Exit Shikari: posts the ante 85
Mr.Skapone: posts the ante 85
1LATESHOW1: posts the ante 85
malik_msk: posts the ante 85
justcallme76: posts the ante 85
vikim08: posts small blind 350
heuler27: posts big blind 700
*** HOLE CARDS ***
Dealt to malik_msk [6d Ad]
londrino: raises 2100 to 2800
Exit Shikari: folds 
Mr.Skapone: folds 
1LATESHOW1: folds 
malik_msk: folds 
justcallme76 is connected 
justcallme76: folds 
Gismo&Merlin: folds 
vikim08: folds 
heuler27: folds 
Uncalled bet (2100) returned to londrino
londrino collected 2515 from pot
*** SUMMARY ***
Total pot 2515 | Rake 0 
Seat 1: Gismo&Merlin (button) folded before Flop (didn't bet)
Seat 2: vikim08 (small blind) folded before Flop
Seat 3: heuler27 (big blind) folded before Flop
Seat 4: londrino collected (2515)
Seat 5: Exit Shikari folded before Flop (didn't bet)
Seat 6: Mr.Skapone folded before Flop (didn't bet)
Seat 7: 1LATESHOW1 folded before Flop (didn't bet)
Seat 8: malik_msk folded before Flop (didn't bet)
Seat 9: justcallme76 folded before Flop (didn't bet)



PokerStars Game #69712784354: Tournament #544010396, $20+$2 USD Hold'em No Limit - Level XVI (350/700) - 2011/10/29 22:52:05 MSK [2011/10/29 14:52:05 ET]
Table '544010396 89' 9-max Seat #2 is the button
Seat 1: Gismo&Merlin (16019 in chips) 
Seat 2: vikim08 (12013 in chips) 
Seat 3: heuler27 (38799 in chips) 
Seat 4: londrino (59190 in chips) 
Seat 5: Exit Shikari (32940 in chips) 
Seat 6: Mr.Skapone (7356 in chips) 
Seat 7: 1LATESHOW1 (6214 in chips) 
Seat 8: malik_msk (22714 in chips) 
Seat 9: justcallme76 (16849 in chips) 
Gismo&Merlin: posts the ante 85
vikim08: posts the ante 85
heuler27: posts the ante 85
londrino: posts the ante 85
Exit Shikari: posts the ante 85
Mr.Skapone: posts the ante 85
1LATESHOW1: posts the ante 85
malik_msk: posts the ante 85
justcallme76: posts the ante 85
heuler27: posts small blind 350
londrino: posts big blind 700
*** HOLE CARDS ***
Dealt to malik_msk [Qs 6h]
Exit Shikari: folds 
Mr.Skapone: folds 
1LATESHOW1: folds 
malik_msk: folds 
justcallme76: folds 
Gismo&Merlin: folds 
vikim08: folds 
heuler27: calls 350
londrino: checks 
*** FLOP *** [8d Jh 7s]
heuler27: bets 1400
londrino: calls 1400
*** TURN *** [8d Jh 7s] [2c]
heuler27: checks 
londrino: checks 
*** RIVER *** [8d Jh 7s 2c] [Qh]
heuler27: checks 
londrino: checks 
*** SHOW DOWN ***
heuler27: shows [5h 9c] (high card Queen)
londrino: shows [Tc 5s] (high card Queen - Jack+Ten kicker)
londrino collected 4965 from pot
*** SUMMARY ***
Total pot 4965 | Rake 0 
Board [8d Jh 7s 2c Qh]
Seat 1: Gismo&Merlin folded before Flop (didn't bet)
Seat 2: vikim08 (button) folded before Flop (didn't bet)
Seat 3: heuler27 (small blind) showed [5h 9c] and lost with high card Queen
Seat 4: londrino (big blind) showed [Tc 5s] and won (4965) with high card Queen
Seat 5: Exit Shikari folded before Flop (didn't bet)
Seat 6: Mr.Skapone folded before Flop (didn't bet)
Seat 7: 1LATESHOW1 folded before Flop (didn't bet)
Seat 8: malik_msk folded before Flop (didn't bet)
Seat 9: justcallme76 folded before Flop (didn't bet)



PokerStars Game #69712833199: Tournament #544010396, $20+$2 USD Hold'em No Limit - Level XVI (350/700) - 2011/10/29 22:52:57 MSK [2011/10/29 14:52:57 ET]
Table '544010396 89' 9-max Seat #3 is the button
Seat 1: Gismo&Merlin (15934 in chips) 
Seat 2: vikim08 (11928 in chips) 
Seat 3: heuler27 (36614 in chips) 
Seat 4: londrino (61970 in chips) 
Seat 5: Exit Shikari (32855 in chips) 
Seat 6: Mr.Skapone (7271 in chips) 
Seat 7: 1LATESHOW1 (6129 in chips) 
Seat 8: malik_msk (22629 in chips) 
Seat 9: justcallme76 (16764 in chips) 
Gismo&Merlin: posts the ante 85
vikim08: posts the ante 85
heuler27: posts the ante 85
londrino: posts the ante 85
Exit Shikari: posts the ante 85
Mr.Skapone: posts the ante 85
1LATESHOW1: posts the ante 85
malik_msk: posts the ante 85
justcallme76: posts the ante 85
londrino: posts small blind 350
Exit Shikari: posts big blind 700
*** HOLE CARDS ***
Dealt to malik_msk [6c Js]
Mr.Skapone: folds 
1LATESHOW1: folds 
malik_msk: folds 
justcallme76: folds 
Gismo&Merlin: folds 
vikim08: folds 
heuler27: raises 1400 to 2100
londrino: folds 
Exit Shikari: folds 
Uncalled bet (1400) returned to heuler27
heuler27 collected 2515 from pot
heuler27: doesn't show hand 
*** SUMMARY ***
Total pot 2515 | Rake 0 
Seat 1: Gismo&Merlin folded before Flop (didn't bet)
Seat 2: vikim08 folded before Flop (didn't bet)
Seat 3: heuler27 (button) collected (2515)
Seat 4: londrino (small blind) folded before Flop
Seat 5: Exit Shikari (big blind) folded before Flop
Seat 6: Mr.Skapone folded before Flop (didn't bet)
Seat 7: 1LATESHOW1 folded before Flop (didn't bet)
Seat 8: malik_msk folded before Flop (didn't bet)
Seat 9: justcallme76 folded before Flop (didn't bet)



PokerStars Game #69712869014: Tournament #544010396, $20+$2 USD Hold'em No Limit - Level XVI (350/700) - 2011/10/29 22:53:35 MSK [2011/10/29 14:53:35 ET]
Table '544010396 89' 9-max Seat #4 is the button
Seat 1: Gismo&Merlin (15849 in chips) 
Seat 2: vikim08 (11843 in chips) 
Seat 3: heuler27 (38344 in chips) 
Seat 4: londrino (61535 in chips) 
Seat 5: Exit Shikari (32070 in chips) 
Seat 6: Mr.Skapone (7186 in chips) 
Seat 7: 1LATESHOW1 (6044 in chips) 
Seat 8: malik_msk (22544 in chips) 
Seat 9: justcallme76 (16679 in chips) 
Gismo&Merlin: posts the ante 85
vikim08: posts the ante 85
heuler27: posts the ante 85
londrino: posts the ante 85
Exit Shikari: posts the ante 85
Mr.Skapone: posts the ante 85
1LATESHOW1: posts the ante 85
malik_msk: posts the ante 85
justcallme76: posts the ante 85
Exit Shikari: posts small blind 350
Mr.Skapone: posts big blind 700
*** HOLE CARDS ***
Dealt to malik_msk [4h 5d]
1LATESHOW1: folds 
malik_msk: folds 
justcallme76: folds 
Gismo&Merlin: folds 
vikim08: folds 
heuler27: folds 
londrino: raises 2100 to 2800
Exit Shikari: folds 
Mr.Skapone: folds 
Uncalled bet (2100) returned to londrino
londrino collected 2515 from pot
*** SUMMARY ***
Total pot 2515 | Rake 0 
Seat 1: Gismo&Merlin folded before Flop (didn't bet)
Seat 2: vikim08 folded before Flop (didn't bet)
Seat 3: heuler27 folded before Flop (didn't bet)
Seat 4: londrino (button) collected (2515)
Seat 5: Exit Shikari (small blind) folded before Flop
Seat 6: Mr.Skapone (big blind) folded before Flop
Seat 7: 1LATESHOW1 folded before Flop (didn't bet)
Seat 8: malik_msk folded before Flop (didn't bet)
Seat 9: justcallme76 folded before Flop (didn't bet)



PokerStars Game #69712941685: Tournament #544010396, $20+$2 USD Hold'em No Limit - Level XVII (400/800) - 2011/10/29 22:54:54 MSK [2011/10/29 14:54:54 ET]
Table '544010396 89' 9-max Seat #5 is the button
Seat 1: Gismo&Merlin (15764 in chips) 
Seat 2: vikim08 (11758 in chips) 
Seat 3: heuler27 (38259 in chips) 
Seat 4: londrino (63265 in chips) 
Seat 5: Exit Shikari (31635 in chips) 
Seat 6: Mr.Skapone (6401 in chips) 
Seat 7: 1LATESHOW1 (5959 in chips) 
Seat 8: malik_msk (22459 in chips) 
Seat 9: justcallme76 (16594 in chips) 
Gismo&Merlin: posts the ante 100
vikim08: posts the ante 100
heuler27: posts the ante 100
londrino: posts the ante 100
Exit Shikari: posts the ante 100
Mr.Skapone: posts the ante 100
1LATESHOW1: posts the ante 100
malik_msk: posts the ante 100
justcallme76: posts the ante 100
Mr.Skapone: posts small blind 400
1LATESHOW1: posts big blind 800
*** HOLE CARDS ***
Dealt to malik_msk [Jd Ah]
malik_msk: calls 800
justcallme76 is disconnected 
justcallme76 is connected 
justcallme76: calls 800
Gismo&Merlin: folds 
vikim08: folds 
heuler27: folds 
londrino: calls 800
Exit Shikari: folds 
Mr.Skapone: folds 
1LATESHOW1: checks 
*** FLOP *** [2d 7d Js]
justcallme76 is connected 
1LATESHOW1 has timed out
1LATESHOW1: checks 
malik_msk: bets 4000
justcallme76: folds 
londrino: folds 
1LATESHOW1: folds 
Uncalled bet (4000) returned to malik_msk
malik_msk collected 4500 from pot
malik_msk: doesn't show hand 
*** SUMMARY ***
Total pot 4500 | Rake 0 
Board [2d 7d Js]
Seat 1: Gismo&Merlin folded before Flop (didn't bet)
Seat 2: vikim08 folded before Flop (didn't bet)
Seat 3: heuler27 folded before Flop (didn't bet)
Seat 4: londrino folded on the Flop
Seat 5: Exit Shikari (button) folded before Flop (didn't bet)
Seat 6: Mr.Skapone (small blind) folded before Flop
Seat 7: 1LATESHOW1 (big blind) folded on the Flop
Seat 8: malik_msk collected (4500)
Seat 9: justcallme76 folded on the Flop



PokerStars Game #69713314588: Tournament #544010396, $20+$2 USD Hold'em No Limit - Level XVII (400/800) - 2011/10/29 23:03:26 MSK [2011/10/29 15:03:26 ET]
Table '544010396 89' 9-max Seat #6 is the button
Seat 1: Gismo&Merlin (15664 in chips) 
Seat 2: vikim08 (11658 in chips) 
Seat 3: heuler27 (38159 in chips) 
Seat 4: londrino (62365 in chips) 
Seat 5: Exit Shikari (31535 in chips) 
Seat 6: Mr.Skapone (5901 in chips) 
Seat 7: 1LATESHOW1 (5059 in chips) 
Seat 8: malik_msk (26059 in chips) 
Seat 9: justcallme76 (15694 in chips) 
Gismo&Merlin: posts the ante 100
vikim08: posts the ante 100
heuler27: posts the ante 100
londrino: posts the ante 100
Exit Shikari: posts the ante 100
Mr.Skapone: posts the ante 100
1LATESHOW1: posts the ante 100
malik_msk: posts the ante 100
justcallme76: posts the ante 100
1LATESHOW1: posts small blind 400
malik_msk: posts big blind 800
*** HOLE CARDS ***
Dealt to malik_msk [6h Jc]
justcallme76 has timed out while being disconnected
justcallme76: folds 
justcallme76 is sitting out
justcallme76 is connected 
Gismo&Merlin: folds 
vikim08: folds 
heuler27: folds 
londrino: folds 
Exit Shikari: folds 
Mr.Skapone: raises 5001 to 5801 and is all-in
1LATESHOW1: calls 4559 and is all-in
malik_msk: folds 
Uncalled bet (842) returned to Mr.Skapone
*** FLOP *** [Tc Ts 7h]
*** TURN *** [Tc Ts 7h] [3c]
*** RIVER *** [Tc Ts 7h 3c] [8d]
*** SHOW DOWN ***
1LATESHOW1: shows [Jd Ks] (a pair of Tens)
Mr.Skapone: shows [Ac 3h] (two pair, Tens and Threes)
Mr.Skapone collected 11618 from pot
1LATESHOW1 finished the tournament in 446th place and received $30.42.
*** SUMMARY ***
Total pot 11618 | Rake 0 
Board [Tc Ts 7h 3c 8d]
Seat 1: Gismo&Merlin folded before Flop (didn't bet)
Seat 2: vikim08 folded before Flop (didn't bet)
Seat 3: heuler27 folded before Flop (didn't bet)
Seat 4: londrino folded before Flop (didn't bet)
Seat 5: Exit Shikari folded before Flop (didn't bet)
Seat 6: Mr.Skapone (button) showed [Ac 3h] and won (11618) with two pair, Tens and Threes
Seat 7: 1LATESHOW1 (small blind) showed [Jd Ks] and lost with a pair of Tens
Seat 8: malik_msk (big blind) folded before Flop
Seat 9: justcallme76 folded before Flop (didn't bet)



PokerStars Game #69713380681: Tournament #544010396, $20+$2 USD Hold'em No Limit - Level XVII (400/800) - 2011/10/29 23:04:35 MSK [2011/10/29 15:04:35 ET]
Table '544010396 89' 9-max Seat #8 is the button
Seat 1: Gismo&Merlin (15564 in chips) 
Seat 2: vikim08 (11558 in chips) 
Seat 3: heuler27 (38059 in chips) 
Seat 4: londrino (62265 in chips) 
Seat 5: Exit Shikari (31435 in chips) 
Seat 6: Mr.Skapone (12460 in chips) 
Seat 8: malik_msk (25159 in chips) 
Seat 9: justcallme76 (15594 in chips) is sitting out
Gismo&Merlin: posts the ante 100
vikim08: posts the ante 100
heuler27: posts the ante 100
londrino: posts the ante 100
Exit Shikari: posts the ante 100
Mr.Skapone: posts the ante 100
malik_msk: posts the ante 100
justcallme76: posts the ante 100
justcallme76: posts small blind 400
Gismo&Merlin: posts big blind 800
*** HOLE CARDS ***
Dealt to malik_msk [Ts 6c]
vikim08: folds 
heuler27: folds 
londrino: folds 
Exit Shikari: raises 1400 to 2200
justcallme76 has returned
Mr.Skapone: folds 
malik_msk: folds 
willem.lodt is connected 
justcallme76: folds 
Gismo&Merlin: folds 
Uncalled bet (1400) returned to Exit Shikari
Exit Shikari collected 2800 from pot
Exit Shikari: doesn't show hand 
*** SUMMARY ***
Total pot 2800 | Rake 0 
Seat 1: Gismo&Merlin (big blind) folded before Flop
Seat 2: vikim08 folded before Flop (didn't bet)
Seat 3: heuler27 folded before Flop (didn't bet)
Seat 4: londrino folded before Flop (didn't bet)
Seat 5: Exit Shikari collected (2800)
Seat 6: Mr.Skapone folded before Flop (didn't bet)
Seat 8: malik_msk (button) folded before Flop (didn't bet)
Seat 9: justcallme76 (small blind) folded before Flop



PokerStars Game #69713433996: Tournament #544010396, $20+$2 USD Hold'em No Limit - Level XVII (400/800) - 2011/10/29 23:05:30 MSK [2011/10/29 15:05:30 ET]
Table '544010396 89' 9-max Seat #9 is the button
Seat 1: Gismo&Merlin (14664 in chips) 
Seat 2: vikim08 (11458 in chips) 
Seat 3: heuler27 (37959 in chips) 
Seat 4: londrino (62165 in chips) 
Seat 5: Exit Shikari (33335 in chips) 
Seat 6: Mr.Skapone (12360 in chips) 
Seat 7: willem.lodt (25072 in chips) 
Seat 8: malik_msk (25059 in chips) 
Seat 9: justcallme76 (15094 in chips) 
Gismo&Merlin: posts the ante 100
vikim08: posts the ante 100
heuler27: posts the ante 100
londrino: posts the ante 100
Exit Shikari: posts the ante 100
Mr.Skapone: posts the ante 100
willem.lodt: posts the ante 100
malik_msk: posts the ante 100
justcallme76: posts the ante 100
Gismo&Merlin: posts small blind 400
vikim08: posts big blind 800
*** HOLE CARDS ***
Dealt to malik_msk [Kh Js]
heuler27: raises 1600 to 2400
londrino: folds 
Exit Shikari: folds 
Mr.Skapone: folds 
willem.lodt: folds 
malik_msk: calls 2400
justcallme76: folds 
Gismo&Merlin: folds 
vikim08: folds 
*** FLOP *** [Jd 2h Qd]
heuler27: checks 
malik_msk: checks 
*** TURN *** [Jd 2h Qd] [9c]
heuler27: bets 2400
malik_msk: raises 8000 to 10400
heuler27: folds 
Uncalled bet (8000) returned to malik_msk
malik_msk collected 11700 from pot
malik_msk: doesn't show hand 
*** SUMMARY ***
Total pot 11700 | Rake 0 
Board [Jd 2h Qd 9c]
Seat 1: Gismo&Merlin (small blind) folded before Flop
Seat 2: vikim08 (big blind) folded before Flop
Seat 3: heuler27 folded on the Turn
Seat 4: londrino folded before Flop (didn't bet)
Seat 5: Exit Shikari folded before Flop (didn't bet)
Seat 6: Mr.Skapone folded before Flop (didn't bet)
Seat 7: willem.lodt folded before Flop (didn't bet)
Seat 8: malik_msk collected (11700)
Seat 9: justcallme76 (button) folded before Flop (didn't bet)



PokerStars Game #69713505745: Tournament #544010396, $20+$2 USD Hold'em No Limit - Level XVII (400/800) - 2011/10/29 23:06:43 MSK [2011/10/29 15:06:43 ET]
Table '544010396 89' 9-max Seat #1 is the button
Seat 1: Gismo&Merlin (14164 in chips) 
Seat 2: vikim08 (10558 in chips) 
Seat 3: heuler27 (33059 in chips) 
Seat 4: londrino (62065 in chips) 
Seat 5: Exit Shikari (33235 in chips) 
Seat 6: Mr.Skapone (12260 in chips) 
Seat 7: willem.lodt (24972 in chips) 
Seat 8: malik_msk (31859 in chips) 
Seat 9: justcallme76 (14994 in chips) 
Gismo&Merlin: posts the ante 100
vikim08: posts the ante 100
heuler27: posts the ante 100
londrino: posts the ante 100
Exit Shikari: posts the ante 100
Mr.Skapone: posts the ante 100
willem.lodt: posts the ante 100
malik_msk: posts the ante 100
justcallme76: posts the ante 100
vikim08: posts small blind 400
heuler27: posts big blind 800
*** HOLE CARDS ***
Dealt to malik_msk [9h 2c]
londrino: folds 
Exit Shikari: folds 
Mr.Skapone: raises 1200 to 2000
willem.lodt: raises 4400 to 6400
malik_msk: folds 
justcallme76: folds 
Gismo&Merlin: folds 
vikim08: folds 
heuler27: folds 
Mr.Skapone: folds 
Uncalled bet (4400) returned to willem.lodt
willem.lodt collected 6100 from pot
willem.lodt: doesn't show hand 
*** SUMMARY ***
Total pot 6100 | Rake 0 
Seat 1: Gismo&Merlin (button) folded before Flop (didn't bet)
Seat 2: vikim08 (small blind) folded before Flop
Seat 3: heuler27 (big blind) folded before Flop
Seat 4: londrino folded before Flop (didn't bet)
Seat 5: Exit Shikari folded before Flop (didn't bet)
Seat 6: Mr.Skapone folded before Flop
Seat 7: willem.lodt collected (6100)
Seat 8: malik_msk folded before Flop (didn't bet)
Seat 9: justcallme76 folded before Flop (didn't bet)



PokerStars Game #69713564143: Tournament #544010396, $20+$2 USD Hold'em No Limit - Level XVII (400/800) - 2011/10/29 23:07:42 MSK [2011/10/29 15:07:42 ET]
Table '544010396 89' 9-max Seat #2 is the button
Seat 1: Gismo&Merlin (14064 in chips) 
Seat 2: vikim08 (10058 in chips) 
Seat 3: heuler27 (32159 in chips) 
Seat 4: londrino (61965 in chips) 
Seat 5: Exit Shikari (33135 in chips) 
Seat 6: Mr.Skapone (10160 in chips) 
Seat 7: willem.lodt (28972 in chips) 
Seat 8: malik_msk (31759 in chips) 
Seat 9: justcallme76 (14894 in chips) 
Gismo&Merlin: posts the ante 100
vikim08: posts the ante 100
heuler27: posts the ante 100
londrino: posts the ante 100
Exit Shikari: posts the ante 100
Mr.Skapone: posts the ante 100
willem.lodt: posts the ante 100
malik_msk: posts the ante 100
justcallme76: posts the ante 100
heuler27: posts small blind 400
londrino: posts big blind 800
*** HOLE CARDS ***
Dealt to malik_msk [Kc 2h]
Exit Shikari: folds 
Mr.Skapone: folds 
willem.lodt: calls 800
malik_msk: folds 
justcallme76: folds 
Gismo&Merlin: calls 800
vikim08: folds 
heuler27: calls 400
londrino: checks 
*** FLOP *** [5d Jd Ts]
heuler27: bets 2400
londrino: calls 2400
justcallme76 is disconnected 
justcallme76 is connected 
willem.lodt: folds 
Gismo&Merlin: calls 2400
*** TURN *** [5d Jd Ts] [3s]
heuler27: bets 5600
londrino: folds 
Gismo&Merlin: calls 5600
*** RIVER *** [5d Jd Ts 3s] [7s]
heuler27: bets 5600
Gismo&Merlin: folds 
Uncalled bet (5600) returned to heuler27
heuler27 collected 22500 from pot
heuler27: doesn't show hand 
*** SUMMARY ***
Total pot 22500 | Rake 0 
Board [5d Jd Ts 3s 7s]
Seat 1: Gismo&Merlin folded on the River
Seat 2: vikim08 (button) folded before Flop (didn't bet)
Seat 3: heuler27 (small blind) collected (22500)
Seat 4: londrino (big blind) folded on the Turn
Seat 5: Exit Shikari folded before Flop (didn't bet)
Seat 6: Mr.Skapone folded before Flop (didn't bet)
Seat 7: willem.lodt folded on the Flop
Seat 8: malik_msk folded before Flop (didn't bet)
Seat 9: justcallme76 folded before Flop (didn't bet)



PokerStars Game #69713649795: Tournament #544010396, $20+$2 USD Hold'em No Limit - Level XVII (400/800) - 2011/10/29 23:09:09 MSK [2011/10/29 15:09:09 ET]
Table '544010396 89' 9-max Seat #3 is the button
Seat 1: Gismo&Merlin (5164 in chips) 
Seat 2: vikim08 (9958 in chips) 
Seat 3: heuler27 (45759 in chips) 
Seat 4: londrino (58665 in chips) 
Seat 5: Exit Shikari (33035 in chips) 
Seat 6: Mr.Skapone (10060 in chips) 
Seat 7: willem.lodt (28072 in chips) 
Seat 8: malik_msk (31659 in chips) 
Seat 9: justcallme76 (14794 in chips) 
Gismo&Merlin: posts the ante 100
vikim08: posts the ante 100
heuler27: posts the ante 100
londrino: posts the ante 100
Exit Shikari: posts the ante 100
Mr.Skapone: posts the ante 100
willem.lodt: posts the ante 100
malik_msk: posts the ante 100
justcallme76: posts the ante 100
londrino: posts small blind 400
Exit Shikari: posts big blind 800
*** HOLE CARDS ***
Dealt to malik_msk [9d 7h]
Mr.Skapone: folds 
willem.lodt: folds 
malik_msk: folds 
justcallme76: raises 1600 to 2400
Gismo&Merlin: folds 
vikim08: folds 
heuler27: folds 
londrino: folds 
Exit Shikari: folds 
Uncalled bet (1600) returned to justcallme76
justcallme76 collected 2900 from pot
*** SUMMARY ***
Total pot 2900 | Rake 0 
Seat 1: Gismo&Merlin folded before Flop (didn't bet)
Seat 2: vikim08 folded before Flop (didn't bet)
Seat 3: heuler27 (button) folded before Flop (didn't bet)
Seat 4: londrino (small blind) folded before Flop
Seat 5: Exit Shikari (big blind) folded before Flop
Seat 6: Mr.Skapone folded before Flop (didn't bet)
Seat 7: willem.lodt folded before Flop (didn't bet)
Seat 8: malik_msk folded before Flop (didn't bet)
Seat 9: justcallme76 collected (2900)



PokerStars Game #69713700023: Tournament #544010396, $20+$2 USD Hold'em No Limit - Level XVII (400/800) - 2011/10/29 23:10:00 MSK [2011/10/29 15:10:00 ET]
Table '544010396 89' 9-max Seat #4 is the button
Seat 1: Gismo&Merlin (5064 in chips) 
Seat 2: vikim08 (9858 in chips) 
Seat 3: heuler27 (45659 in chips) 
Seat 4: londrino (58165 in chips) 
Seat 5: Exit Shikari (32135 in chips) 
Seat 6: Mr.Skapone (9960 in chips) 
Seat 7: willem.lodt (27972 in chips) 
Seat 8: malik_msk (31559 in chips) 
Seat 9: justcallme76 (16794 in chips) 
Gismo&Merlin: posts the ante 100
vikim08: posts the ante 100
heuler27: posts the ante 100
londrino: posts the ante 100
Exit Shikari: posts the ante 100
Mr.Skapone: posts the ante 100
willem.lodt: posts the ante 100
malik_msk: posts the ante 100
justcallme76: posts the ante 100
Exit Shikari: posts small blind 400
Mr.Skapone: posts big blind 800
*** HOLE CARDS ***
Dealt to malik_msk [6d Ks]
willem.lodt: folds 
malik_msk: folds 
justcallme76: folds 
Gismo&Merlin: folds 
vikim08: folds 
heuler27: raises 1600 to 2400
londrino: folds 
Exit Shikari: raises 3200 to 5600
Mr.Skapone: folds 
heuler27: folds 
Uncalled bet (3200) returned to Exit Shikari
Exit Shikari collected 6500 from pot
Exit Shikari: doesn't show hand 
*** SUMMARY ***
Total pot 6500 | Rake 0 
Seat 1: Gismo&Merlin folded before Flop (didn't bet)
Seat 2: vikim08 folded before Flop (didn't bet)
Seat 3: heuler27 folded before Flop
Seat 4: londrino (button) folded before Flop (didn't bet)
Seat 5: Exit Shikari (small blind) collected (6500)
Seat 6: Mr.Skapone (big blind) folded before Flop
Seat 7: willem.lodt folded before Flop (didn't bet)
Seat 8: malik_msk folded before Flop (didn't bet)
Seat 9: justcallme76 folded before Flop (didn't bet)



PokerStars Game #69713755829: Tournament #544010396, $20+$2 USD Hold'em No Limit - Level XVII (400/800) - 2011/10/29 23:10:57 MSK [2011/10/29 15:10:57 ET]
Table '544010396 89' 9-max Seat #5 is the button
Seat 1: Gismo&Merlin (4964 in chips) 
Seat 2: vikim08 (9758 in chips) 
Seat 3: heuler27 (43159 in chips) 
Seat 4: londrino (58065 in chips) 
Seat 5: Exit Shikari (36135 in chips) 
Seat 6: Mr.Skapone (9060 in chips) 
Seat 7: willem.lodt (27872 in chips) 
Seat 8: malik_msk (31459 in chips) 
Seat 9: justcallme76 (16694 in chips) 
Gismo&Merlin: posts the ante 100
vikim08: posts the ante 100
heuler27: posts the ante 100
londrino: posts the ante 100
Exit Shikari: posts the ante 100
Mr.Skapone: posts the ante 100
willem.lodt: posts the ante 100
malik_msk: posts the ante 100
justcallme76: posts the ante 100
Mr.Skapone: posts small blind 400
willem.lodt: posts big blind 800
*** HOLE CARDS ***
Dealt to malik_msk [Kh 7h]
malik_msk: calls 800
justcallme76: folds 
Gismo&Merlin: folds 
vikim08: folds 
heuler27: folds 
londrino: folds 
Exit Shikari: folds 
Mr.Skapone: raises 8160 to 8960 and is all-in
willem.lodt: folds 
malik_msk: folds 
Uncalled bet (8160) returned to Mr.Skapone
Mr.Skapone collected 3300 from pot
*** SUMMARY ***
Total pot 3300 | Rake 0 
Seat 1: Gismo&Merlin folded before Flop (didn't bet)
Seat 2: vikim08 folded before Flop (didn't bet)
Seat 3: heuler27 folded before Flop (didn't bet)
Seat 4: londrino folded before Flop (didn't bet)
Seat 5: Exit Shikari (button) folded before Flop (didn't bet)
Seat 6: Mr.Skapone (small blind) collected (3300)
Seat 7: willem.lodt (big blind) folded before Flop
Seat 8: malik_msk folded before Flop
Seat 9: justcallme76 folded before Flop (didn't bet)



PokerStars Game #69713828836: Tournament #544010396, $20+$2 USD Hold'em No Limit - Level XVII (400/800) - 2011/10/29 23:12:12 MSK [2011/10/29 15:12:12 ET]
Table '544010396 89' 9-max Seat #6 is the button
Seat 1: Gismo&Merlin (4864 in chips) 
Seat 2: vikim08 (9658 in chips) 
Seat 3: heuler27 (43059 in chips) 
Seat 4: londrino (57965 in chips) 
Seat 5: Exit Shikari (36035 in chips) 
Seat 6: Mr.Skapone (11460 in chips) 
Seat 7: willem.lodt (26972 in chips) 
Seat 8: malik_msk (30559 in chips) 
Seat 9: justcallme76 (16594 in chips) 
Gismo&Merlin: posts the ante 100
vikim08: posts the ante 100
heuler27: posts the ante 100
londrino: posts the ante 100
Exit Shikari: posts the ante 100
Mr.Skapone: posts the ante 100
willem.lodt: posts the ante 100
malik_msk: posts the ante 100
justcallme76: posts the ante 100
willem.lodt: posts small blind 400
malik_msk: posts big blind 800
*** HOLE CARDS ***
Dealt to malik_msk [Ah 6d]
justcallme76 is disconnected 
justcallme76 is connected 
justcallme76: folds 
Gismo&Merlin: folds 
vikim08: folds 
heuler27: folds 
londrino: raises 1600 to 2400
Exit Shikari: folds 
Mr.Skapone: raises 8960 to 11360 and is all-in
willem.lodt: folds 
malik_msk: folds 
londrino: calls 8960
*** FLOP *** [Th 3d 4h]
*** TURN *** [Th 3d 4h] [6h]
*** RIVER *** [Th 3d 4h 6h] [Kd]
*** SHOW DOWN ***
londrino: shows [8d 8s] (a pair of Eights)
Mr.Skapone: shows [As Ks] (a pair of Kings)
Mr.Skapone collected 24820 from pot
*** SUMMARY ***
Total pot 24820 | Rake 0 
Board [Th 3d 4h 6h Kd]
Seat 1: Gismo&Merlin folded before Flop (didn't bet)
Seat 2: vikim08 folded before Flop (didn't bet)
Seat 3: heuler27 folded before Flop (didn't bet)
Seat 4: londrino showed [8d 8s] and lost with a pair of Eights
Seat 5: Exit Shikari folded before Flop (didn't bet)
Seat 6: Mr.Skapone (button) showed [As Ks] and won (24820) with a pair of Kings
Seat 7: willem.lodt (small blind) folded before Flop
Seat 8: malik_msk (big blind) folded before Flop
Seat 9: justcallme76 folded before Flop (didn't bet)



PokerStars Game #69713890920: Tournament #544010396, $20+$2 USD Hold'em No Limit - Level XVIII (500/1000) - 2011/10/29 23:13:17 MSK [2011/10/29 15:13:17 ET]
Table '544010396 89' 9-max Seat #7 is the button
Seat 1: Gismo&Merlin (4764 in chips) 
Seat 2: vikim08 (9558 in chips) 
Seat 3: heuler27 (42959 in chips) 
Seat 4: londrino (46505 in chips) 
Seat 5: Exit Shikari (35935 in chips) 
Seat 6: Mr.Skapone (24820 in chips) 
Seat 7: willem.lodt (26472 in chips) 
Seat 8: malik_msk (29659 in chips) 
Seat 9: justcallme76 (16494 in chips) 
Gismo&Merlin: posts the ante 125
vikim08: posts the ante 125
heuler27: posts the ante 125
londrino: posts the ante 125
Exit Shikari: posts the ante 125
Mr.Skapone: posts the ante 125
willem.lodt: posts the ante 125
malik_msk: posts the ante 125
justcallme76: posts the ante 125
malik_msk: posts small blind 500
justcallme76: posts big blind 1000
*** HOLE CARDS ***
Dealt to malik_msk [4c 6s]
Gismo&Merlin: raises 3639 to 4639 and is all-in
vikim08: folds 
heuler27: calls 4639
londrino: folds 
Exit Shikari: folds 
Mr.Skapone: folds 
willem.lodt: folds 
malik_msk: folds 
justcallme76 is connected 
justcallme76: folds 
*** FLOP *** [5h Ac Td]
*** TURN *** [5h Ac Td] [7h]
*** RIVER *** [5h Ac Td 7h] [9c]
*** SHOW DOWN ***
Gismo&Merlin: shows [Jh Ah] (a pair of Aces)
heuler27: shows [As Jc] (a pair of Aces)
Gismo&Merlin collected 5952 from pot
heuler27 collected 5951 from pot
*** SUMMARY ***
Total pot 11903 | Rake 0 
Board [5h Ac Td 7h 9c]
Seat 1: Gismo&Merlin showed [Jh Ah] and won (5952) with a pair of Aces
Seat 2: vikim08 folded before Flop (didn't bet)
Seat 3: heuler27 showed [As Jc] and won (5951) with a pair of Aces
Seat 4: londrino folded before Flop (didn't bet)
Seat 5: Exit Shikari folded before Flop (didn't bet)
Seat 6: Mr.Skapone folded before Flop (didn't bet)
Seat 7: willem.lodt (button) folded before Flop (didn't bet)
Seat 8: malik_msk (small blind) folded before Flop
Seat 9: justcallme76 (big blind) folded before Flop



PokerStars Game #69713968776: Tournament #544010396, $20+$2 USD Hold'em No Limit - Level XVIII (500/1000) - 2011/10/29 23:14:37 MSK [2011/10/29 15:14:37 ET]
Table '544010396 89' 9-max Seat #8 is the button
Seat 1: Gismo&Merlin (5952 in chips) 
Seat 2: vikim08 (9433 in chips) 
Seat 3: heuler27 (44146 in chips) 
Seat 4: londrino (46380 in chips) 
Seat 5: Exit Shikari (35810 in chips) 
Seat 6: Mr.Skapone (24695 in chips) 
Seat 7: willem.lodt (26347 in chips) 
Seat 8: malik_msk (29034 in chips) 
Seat 9: justcallme76 (15369 in chips) 
Gismo&Merlin: posts the ante 125
vikim08: posts the ante 125
heuler27: posts the ante 125
londrino: posts the ante 125
Exit Shikari: posts the ante 125
Mr.Skapone: posts the ante 125
willem.lodt: posts the ante 125
malik_msk: posts the ante 125
justcallme76: posts the ante 125
justcallme76: posts small blind 500
Gismo&Merlin: posts big blind 1000
*** HOLE CARDS ***
Dealt to malik_msk [Js 7s]
vikim08: folds 
heuler27: folds 
londrino: calls 1000
Exit Shikari: folds 
Mr.Skapone: raises 3000 to 4000
willem.lodt: folds 
malik_msk: folds 
justcallme76 is connected 
justcallme76: folds 
Gismo&Merlin: folds 
londrino: calls 3000
*** FLOP *** [Kh 9c 2s]
londrino: checks 
Mr.Skapone: checks 
*** TURN *** [Kh 9c 2s] [9h]
londrino: bets 8000
Mr.Skapone: folds 
Uncalled bet (8000) returned to londrino
londrino collected 10625 from pot
*** SUMMARY ***
Total pot 10625 | Rake 0 
Board [Kh 9c 2s 9h]
Seat 1: Gismo&Merlin (big blind) folded before Flop
Seat 2: vikim08 folded before Flop (didn't bet)
Seat 3: heuler27 folded before Flop (didn't bet)
Seat 4: londrino collected (10625)
Seat 5: Exit Shikari folded before Flop (didn't bet)
Seat 6: Mr.Skapone folded on the Turn
Seat 7: willem.lodt folded before Flop (didn't bet)
Seat 8: malik_msk (button) folded before Flop (didn't bet)
Seat 9: justcallme76 (small blind) folded before Flop



PokerStars Game #69714079789: Tournament #544010396, $20+$2 USD Hold'em No Limit - Level XVIII (500/1000) - 2011/10/29 23:16:32 MSK [2011/10/29 15:16:32 ET]
Table '544010396 89' 9-max Seat #9 is the button
Seat 1: Gismo&Merlin (4827 in chips) 
Seat 2: vikim08 (9308 in chips) 
Seat 3: heuler27 (44021 in chips) 
Seat 4: londrino (52880 in chips) 
Seat 5: Exit Shikari (35685 in chips) 
Seat 6: Mr.Skapone (20570 in chips) 
Seat 7: willem.lodt (26222 in chips) 
Seat 8: malik_msk (28909 in chips) 
Seat 9: justcallme76 (14744 in chips) 
Gismo&Merlin: posts the ante 125
vikim08: posts the ante 125
heuler27: posts the ante 125
londrino: posts the ante 125
Exit Shikari: posts the ante 125
Mr.Skapone: posts the ante 125
willem.lodt: posts the ante 125
malik_msk: posts the ante 125
justcallme76: posts the ante 125
Gismo&Merlin: posts small blind 500
vikim08: posts big blind 1000
*** HOLE CARDS ***
Dealt to malik_msk [3s 3h]
heuler27: folds 
londrino: calls 1000
Exit Shikari: calls 1000
Mr.Skapone: folds 
willem.lodt: folds 
malik_msk: calls 1000
justcallme76: folds 
Gismo&Merlin: calls 500
vikim08: checks 
*** FLOP *** [6d Qd Qh]
Gismo&Merlin: checks 
vikim08: checks 
londrino: bets 4000
Exit Shikari: folds 
malik_msk: folds 
Gismo&Merlin: folds 
vikim08: folds 
Uncalled bet (4000) returned to londrino
londrino collected 6125 from pot
*** SUMMARY ***
Total pot 6125 | Rake 0 
Board [6d Qd Qh]
Seat 1: Gismo&Merlin (small blind) folded on the Flop
Seat 2: vikim08 (big blind) folded on the Flop
Seat 3: heuler27 folded before Flop (didn't bet)
Seat 4: londrino collected (6125)
Seat 5: Exit Shikari folded on the Flop
Seat 6: Mr.Skapone folded before Flop (didn't bet)
Seat 7: willem.lodt folded before Flop (didn't bet)
Seat 8: malik_msk folded on the Flop
Seat 9: justcallme76 (button) folded before Flop (didn't bet)



PokerStars Game #69714185503: Tournament #544010396, $20+$2 USD Hold'em No Limit - Level XVIII (500/1000) - 2011/10/29 23:18:21 MSK [2011/10/29 15:18:21 ET]
Table '544010396 89' 9-max Seat #1 is the button
Seat 1: Gismo&Merlin (3702 in chips) 
Seat 2: vikim08 (8183 in chips) 
Seat 3: heuler27 (43896 in chips) 
Seat 4: londrino (57880 in chips) 
Seat 5: Exit Shikari (34560 in chips) 
Seat 6: Mr.Skapone (20445 in chips) 
Seat 7: willem.lodt (26097 in chips) 
Seat 8: malik_msk (27784 in chips) 
Seat 9: justcallme76 (14619 in chips) 
Gismo&Merlin: posts the ante 125
vikim08: posts the ante 125
heuler27: posts the ante 125
londrino: posts the ante 125
Exit Shikari: posts the ante 125
Mr.Skapone: posts the ante 125
willem.lodt: posts the ante 125
malik_msk: posts the ante 125
justcallme76: posts the ante 125
vikim08: posts small blind 500
heuler27: posts big blind 1000
*** HOLE CARDS ***
Dealt to malik_msk [5s 6d]
londrino: folds 
Exit Shikari: folds 
Mr.Skapone: folds 
willem.lodt: folds 
malik_msk: folds 
justcallme76: raises 2000 to 3000
Gismo&Merlin: raises 577 to 3577 and is all-in
vikim08: folds 
heuler27: calls 2577
justcallme76: calls 577
*** FLOP *** [Jc Th Jd]
heuler27: checks 
justcallme76: bets 3000
heuler27: raises 3000 to 6000
justcallme76: raises 4917 to 10917 and is all-in
heuler27: calls 4917
*** TURN *** [Jc Th Jd] [Tc]
*** RIVER *** [Jc Th Jd Tc] [4h]
*** SHOW DOWN ***
heuler27: shows [Qc Js] (a full house, Jacks full of Tens)
justcallme76: shows [8h 8s] (two pair, Jacks and Tens)
heuler27 collected 21834 from side pot
Gismo&Merlin: shows [As 3s] (two pair, Jacks and Tens)
heuler27 collected 12356 from main pot
justcallme76 finished the tournament in 332nd place and received $42.58.
Gismo&Merlin finished the tournament in 333rd place and received $42.58.
*** SUMMARY ***
Total pot 34190 Main pot 12356. Side pot 21834. | Rake 0 
Board [Jc Th Jd Tc 4h]
Seat 1: Gismo&Merlin (button) showed [As 3s] and lost with two pair, Jacks and Tens
Seat 2: vikim08 (small blind) folded before Flop
Seat 3: heuler27 (big blind) showed [Qc Js] and won (34190) with a full house, Jacks full of Tens
Seat 4: londrino folded before Flop (didn't bet)
Seat 5: Exit Shikari folded before Flop (didn't bet)
Seat 6: Mr.Skapone folded before Flop (didn't bet)
Seat 7: willem.lodt folded before Flop (didn't bet)
Seat 8: malik_msk folded before Flop (didn't bet)
Seat 9: justcallme76 showed [8h 8s] and lost with two pair, Jacks and Tens



PokerStars Game #69714269702: Tournament #544010396, $20+$2 USD Hold'em No Limit - Level XVIII (500/1000) - 2011/10/29 23:19:48 MSK [2011/10/29 15:19:48 ET]
Table '544010396 89' 9-max Seat #2 is the button
Seat 2: vikim08 (7558 in chips) 
Seat 3: heuler27 (63467 in chips) 
Seat 4: londrino (57755 in chips) 
Seat 5: Exit Shikari (34435 in chips) 
Seat 6: Mr.Skapone (20320 in chips) 
Seat 7: willem.lodt (25972 in chips) 
Seat 8: malik_msk (27659 in chips) 
Seat 9: littlep82 (13904 in chips) 
vikim08: posts the ante 125
heuler27: posts the ante 125
londrino: posts the ante 125
Exit Shikari: posts the ante 125
Mr.Skapone: posts the ante 125
willem.lodt: posts the ante 125
malik_msk: posts the ante 125
littlep82: posts the ante 125
heuler27: posts small blind 500
londrino: posts big blind 1000
*** HOLE CARDS ***
Dealt to malik_msk [Jd Qs]
Exit Shikari: folds 
Mr.Skapone: folds 
willem.lodt: raises 1000 to 2000
malik_msk: calls 2000
littlep82: folds 
vikim08: raises 5433 to 7433 and is all-in
heuler27: folds 
londrino: folds 
willem.lodt: calls 5433
malik_msk: calls 5433
*** FLOP *** [2d 5s 9h]
willem.lodt: bets 6000
malik_msk: folds 
Uncalled bet (6000) returned to willem.lodt
*** TURN *** [2d 5s 9h] [Qc]
*** RIVER *** [2d 5s 9h Qc] [Kd]
*** SHOW DOWN ***
willem.lodt: shows [Td 9s] (a pair of Nines)
vikim08: shows [5d 5c] (three of a kind, Fives)
vikim08 collected 24799 from pot
*** SUMMARY ***
Total pot 24799 | Rake 0 
Board [2d 5s 9h Qc Kd]
Seat 2: vikim08 (button) showed [5d 5c] and won (24799) with three of a kind, Fives
Seat 3: heuler27 (small blind) folded before Flop
Seat 4: londrino (big blind) folded before Flop
Seat 5: Exit Shikari folded before Flop (didn't bet)
Seat 6: Mr.Skapone folded before Flop (didn't bet)
Seat 7: willem.lodt showed [Td 9s] and lost with a pair of Nines
Seat 8: malik_msk folded on the Flop
Seat 9: littlep82 folded before Flop (didn't bet)



PokerStars Game #69714315293: Tournament #544010396, $20+$2 USD Hold'em No Limit - Level XVIII (500/1000) - 2011/10/29 23:20:36 MSK [2011/10/29 15:20:36 ET]
Table '544010396 89' 9-max Seat #3 is the button
Seat 2: vikim08 (24799 in chips) 
Seat 3: heuler27 (62842 in chips) 
Seat 4: londrino (56630 in chips) 
Seat 5: Exit Shikari (34310 in chips) 
Seat 6: Mr.Skapone (20195 in chips) 
Seat 7: willem.lodt (18414 in chips) 
Seat 8: malik_msk (20101 in chips) 
Seat 9: littlep82 (13779 in chips) 
vikim08: posts the ante 125
heuler27: posts the ante 125
londrino: posts the ante 125
Exit Shikari: posts the ante 125
Mr.Skapone: posts the ante 125
willem.lodt: posts the ante 125
malik_msk: posts the ante 125
littlep82: posts the ante 125
londrino: posts small blind 500
Exit Shikari: posts big blind 1000
*** HOLE CARDS ***
Dealt to malik_msk [9d 4h]
Mr.Skapone: folds 
willem.lodt: folds 
malik_msk: folds 
littlep82: folds 
vikim08: folds 
heuler27: folds 
londrino: raises 3000 to 4000
Exit Shikari: folds 
Uncalled bet (3000) returned to londrino
londrino collected 3000 from pot
*** SUMMARY ***
Total pot 3000 | Rake 0 
Seat 2: vikim08 folded before Flop (didn't bet)
Seat 3: heuler27 (button) folded before Flop (didn't bet)
Seat 4: londrino (small blind) collected (3000)
Seat 5: Exit Shikari (big blind) folded before Flop
Seat 6: Mr.Skapone folded before Flop (didn't bet)
Seat 7: willem.lodt folded before Flop (didn't bet)
Seat 8: malik_msk folded before Flop (didn't bet)
Seat 9: littlep82 folded before Flop (didn't bet)



PokerStars Game #69714338608: Tournament #544010396, $20+$2 USD Hold'em No Limit - Level XVIII (500/1000) - 2011/10/29 23:21:01 MSK [2011/10/29 15:21:01 ET]
Table '544010396 89' 9-max Seat #4 is the button
Seat 2: vikim08 (24674 in chips) 
Seat 3: heuler27 (62717 in chips) 
Seat 4: londrino (58505 in chips) 
Seat 5: Exit Shikari (33185 in chips) 
Seat 6: Mr.Skapone (20070 in chips) 
Seat 7: willem.lodt (18289 in chips) 
Seat 8: malik_msk (19976 in chips) 
Seat 9: littlep82 (13654 in chips) 
vikim08: posts the ante 125
heuler27: posts the ante 125
londrino: posts the ante 125
Exit Shikari: posts the ante 125
Mr.Skapone: posts the ante 125
willem.lodt: posts the ante 125
malik_msk: posts the ante 125
littlep82: posts the ante 125
Exit Shikari: posts small blind 500
Mr.Skapone: posts big blind 1000
*** HOLE CARDS ***
Dealt to malik_msk [Td Jc]
willem.lodt: raises 1000 to 2000
malik_msk: folds 
littlep82: folds 
vikim08: folds 
heuler27: folds 
londrino: folds 
Exit Shikari: calls 1500
Mr.Skapone: calls 1000
*** FLOP *** [4d 3c 3d]
Exit Shikari: bets 3000
Mr.Skapone: folds 
willem.lodt: raises 6000 to 9000
EspBju is connected 
Exit Shikari: folds 
Uncalled bet (6000) returned to willem.lodt
willem.lodt collected 13000 from pot
willem.lodt: doesn't show hand 
*** SUMMARY ***
Total pot 13000 | Rake 0 
Board [4d 3c 3d]
Seat 2: vikim08 folded before Flop (didn't bet)
Seat 3: heuler27 folded before Flop (didn't bet)
Seat 4: londrino (button) folded before Flop (didn't bet)
Seat 5: Exit Shikari (small blind) folded on the Flop
Seat 6: Mr.Skapone (big blind) folded on the Flop
Seat 7: willem.lodt collected (13000)
Seat 8: malik_msk folded before Flop (didn't bet)
Seat 9: littlep82 folded before Flop (didn't bet)



PokerStars Game #69714415385: Tournament #544010396, $20+$2 USD Hold'em No Limit - Level XVIII (500/1000) - 2011/10/29 23:22:20 MSK [2011/10/29 15:22:20 ET]
Table '544010396 89' 9-max Seat #5 is the button
Seat 1: EspBju (11942 in chips) 
Seat 2: vikim08 (24549 in chips) 
Seat 3: heuler27 (62592 in chips) 
Seat 4: londrino (58380 in chips) 
Seat 5: Exit Shikari (28060 in chips) 
Seat 6: Mr.Skapone (17945 in chips) 
Seat 7: willem.lodt (26164 in chips) 
Seat 8: malik_msk (19851 in chips) 
Seat 9: littlep82 (13529 in chips) 
EspBju: posts the ante 125
vikim08: posts the ante 125
heuler27: posts the ante 125
londrino: posts the ante 125
Exit Shikari: posts the ante 125
Mr.Skapone: posts the ante 125
willem.lodt: posts the ante 125
malik_msk: posts the ante 125
littlep82: posts the ante 125
Mr.Skapone: posts small blind 500
willem.lodt: posts big blind 1000
*** HOLE CARDS ***
Dealt to malik_msk [3s Kc]
malik_msk: folds 
littlep82: calls 1000
EspBju: calls 1000
vikim08: folds 
heuler27: folds 
londrino: folds 
Exit Shikari: folds 
Mr.Skapone: calls 500
willem.lodt: checks 
*** FLOP *** [6c Ah Ac]
Mr.Skapone: checks 
willem.lodt: checks 
littlep82: checks 
EspBju: bets 2000
Mr.Skapone: folds 
willem.lodt: calls 2000
littlep82: folds 
*** TURN *** [6c Ah Ac] [8c]
willem.lodt: checks 
EspBju: bets 2000
willem.lodt: calls 2000
*** RIVER *** [6c Ah Ac 8c] [Qs]
willem.lodt: checks 
EspBju: checks 
*** SHOW DOWN ***
willem.lodt: shows [Ad 3c] (three of a kind, Aces)
EspBju: mucks hand 
willem.lodt collected 13125 from pot
*** SUMMARY ***
Total pot 13125 | Rake 0 
Board [6c Ah Ac 8c Qs]
Seat 1: EspBju mucked [Qh Jc]
Seat 2: vikim08 folded before Flop (didn't bet)
Seat 3: heuler27 folded before Flop (didn't bet)
Seat 4: londrino folded before Flop (didn't bet)
Seat 5: Exit Shikari (button) folded before Flop (didn't bet)
Seat 6: Mr.Skapone (small blind) folded on the Flop
Seat 7: willem.lodt (big blind) showed [Ad 3c] and won (13125) with three of a kind, Aces
Seat 8: malik_msk folded before Flop (didn't bet)
Seat 9: littlep82 folded on the Flop



PokerStars Game #69714496141: Tournament #544010396, $20+$2 USD Hold'em No Limit - Level XIX (600/1200) - 2011/10/29 23:23:44 MSK [2011/10/29 15:23:44 ET]
Table '544010396 89' 9-max Seat #6 is the button
Seat 1: EspBju (6817 in chips) 
Seat 2: vikim08 (24424 in chips) 
Seat 3: heuler27 (62467 in chips) 
Seat 4: londrino (58255 in chips) 
Seat 5: Exit Shikari (27935 in chips) 
Seat 6: Mr.Skapone (16820 in chips) 
Seat 7: willem.lodt (34164 in chips) 
Seat 8: malik_msk (19726 in chips) 
Seat 9: littlep82 (12404 in chips) 
EspBju: posts the ante 150
vikim08: posts the ante 150
heuler27: posts the ante 150
londrino: posts the ante 150
Exit Shikari: posts the ante 150
Mr.Skapone: posts the ante 150
willem.lodt: posts the ante 150
malik_msk: posts the ante 150
littlep82: posts the ante 150
willem.lodt: posts small blind 600
malik_msk: posts big blind 1200
*** HOLE CARDS ***
Dealt to malik_msk [Js 4h]
littlep82: folds 
EspBju: folds 
vikim08: folds 
heuler27: folds 
londrino: raises 2400 to 3600
Exit Shikari: calls 3600
Mr.Skapone: folds 
willem.lodt: folds 
malik_msk: folds 
*** FLOP *** [9d 7c 5h]
londrino: bets 4800
Exit Shikari: raises 19385 to 24185 and is all-in
londrino: folds 
Uncalled bet (19385) returned to Exit Shikari
Exit Shikari collected 19950 from pot
Exit Shikari: doesn't show hand 
*** SUMMARY ***
Total pot 19950 | Rake 0 
Board [9d 7c 5h]
Seat 1: EspBju folded before Flop (didn't bet)
Seat 2: vikim08 folded before Flop (didn't bet)
Seat 3: heuler27 folded before Flop (didn't bet)
Seat 4: londrino folded on the Flop
Seat 5: Exit Shikari collected (19950)
Seat 6: Mr.Skapone (button) folded before Flop (didn't bet)
Seat 7: willem.lodt (small blind) folded before Flop
Seat 8: malik_msk (big blind) folded before Flop
Seat 9: littlep82 folded before Flop (didn't bet)



PokerStars Game #69714560835: Tournament #544010396, $20+$2 USD Hold'em No Limit - Level XIX (600/1200) - 2011/10/29 23:24:51 MSK [2011/10/29 15:24:51 ET]
Table '544010396 89' 9-max Seat #7 is the button
Seat 1: EspBju (6667 in chips) 
Seat 2: vikim08 (24274 in chips) 
Seat 3: heuler27 (62317 in chips) 
Seat 4: londrino (49705 in chips) 
Seat 5: Exit Shikari (39335 in chips) 
Seat 6: Mr.Skapone (16670 in chips) 
Seat 7: willem.lodt (33414 in chips) 
Seat 8: malik_msk (18376 in chips) 
Seat 9: littlep82 (12254 in chips) 
EspBju: posts the ante 150
vikim08: posts the ante 150
heuler27: posts the ante 150
londrino: posts the ante 150
Exit Shikari: posts the ante 150
Mr.Skapone: posts the ante 150
willem.lodt: posts the ante 150
malik_msk: posts the ante 150
littlep82: posts the ante 150
malik_msk: posts small blind 600
littlep82: posts big blind 1200
*** HOLE CARDS ***
Dealt to malik_msk [Ks Ts]
EspBju: folds 
vikim08: folds 
heuler27: folds 
londrino: folds 
Exit Shikari: folds 
Mr.Skapone: folds 
willem.lodt: raises 1200 to 2400
malik_msk: calls 1800
littlep82: folds 
*** FLOP *** [5h 2c Tc]
malik_msk: bets 7200
willem.lodt: folds 
Uncalled bet (7200) returned to malik_msk
malik_msk collected 7350 from pot
malik_msk: doesn't show hand 
*** SUMMARY ***
Total pot 7350 | Rake 0 
Board [5h 2c Tc]
Seat 1: EspBju folded before Flop (didn't bet)
Seat 2: vikim08 folded before Flop (didn't bet)
Seat 3: heuler27 folded before Flop (didn't bet)
Seat 4: londrino folded before Flop (didn't bet)
Seat 5: Exit Shikari folded before Flop (didn't bet)
Seat 6: Mr.Skapone folded before Flop (didn't bet)
Seat 7: willem.lodt (button) folded on the Flop
Seat 8: malik_msk (small blind) collected (7350)
Seat 9: littlep82 (big blind) folded before Flop



PokerStars Game #69714621508: Tournament #544010396, $20+$2 USD Hold'em No Limit - Level XIX (600/1200) - 2011/10/29 23:25:55 MSK [2011/10/29 15:25:55 ET]
Table '544010396 89' 9-max Seat #8 is the button
Seat 1: EspBju (6517 in chips) 
Seat 2: vikim08 (24124 in chips) 
Seat 3: heuler27 (62167 in chips) 
Seat 4: londrino (49555 in chips) 
Seat 5: Exit Shikari (39185 in chips) 
Seat 6: Mr.Skapone (16520 in chips) 
Seat 7: willem.lodt (30864 in chips) 
Seat 8: malik_msk (23176 in chips) 
Seat 9: littlep82 (10904 in chips) 
EspBju: posts the ante 150
vikim08: posts the ante 150
heuler27: posts the ante 150
londrino: posts the ante 150
Exit Shikari: posts the ante 150
Mr.Skapone: posts the ante 150
willem.lodt: posts the ante 150
malik_msk: posts the ante 150
littlep82: posts the ante 150
littlep82: posts small blind 600
EspBju: posts big blind 1200
*** HOLE CARDS ***
Dealt to malik_msk [Th As]
vikim08: folds 
heuler27: folds 
londrino: folds 
Exit Shikari: folds 
Mr.Skapone: raises 15170 to 16370 and is all-in
willem.lodt: folds 
malik_msk: folds 
littlep82: folds 
EspBju: calls 5167 and is all-in
Uncalled bet (10003) returned to Mr.Skapone
*** FLOP *** [Ad 2d Kh]
*** TURN *** [Ad 2d Kh] [5d]
*** RIVER *** [Ad 2d Kh 5d] [8s]
*** SHOW DOWN ***
EspBju: shows [Jc Jh] (a pair of Jacks)
Mr.Skapone: shows [6d 6c] (a pair of Sixes)
EspBju collected 14684 from pot
*** SUMMARY ***
Total pot 14684 | Rake 0 
Board [Ad 2d Kh 5d 8s]
Seat 1: EspBju (big blind) showed [Jc Jh] and won (14684) with a pair of Jacks
Seat 2: vikim08 folded before Flop (didn't bet)
Seat 3: heuler27 folded before Flop (didn't bet)
Seat 4: londrino folded before Flop (didn't bet)
Seat 5: Exit Shikari folded before Flop (didn't bet)
Seat 6: Mr.Skapone showed [6d 6c] and lost with a pair of Sixes
Seat 7: willem.lodt folded before Flop (didn't bet)
Seat 8: malik_msk (button) folded before Flop (didn't bet)
Seat 9: littlep82 (small blind) folded before Flop



PokerStars Game #69714672840: Tournament #544010396, $20+$2 USD Hold'em No Limit - Level XIX (600/1200) - 2011/10/29 23:26:49 MSK [2011/10/29 15:26:49 ET]
Table '544010396 89' 9-max Seat #9 is the button
Seat 1: EspBju (14684 in chips) 
Seat 2: vikim08 (23974 in chips) 
Seat 3: heuler27 (62017 in chips) 
Seat 4: londrino (49405 in chips) 
Seat 5: Exit Shikari (39035 in chips) 
Seat 6: Mr.Skapone (10003 in chips) 
Seat 7: willem.lodt (30714 in chips) 
Seat 8: malik_msk (23026 in chips) 
Seat 9: littlep82 (10154 in chips) 
EspBju: posts the ante 150
vikim08: posts the ante 150
heuler27: posts the ante 150
londrino: posts the ante 150
Exit Shikari: posts the ante 150
Mr.Skapone: posts the ante 150
willem.lodt: posts the ante 150
malik_msk: posts the ante 150
littlep82: posts the ante 150
EspBju: posts small blind 600
vikim08: posts big blind 1200
*** HOLE CARDS ***
Dealt to malik_msk [9h Qd]
heuler27: raises 3600 to 4800
londrino: folds 
Exit Shikari: folds 
Mr.Skapone: folds 
willem.lodt: folds 
malik_msk: folds 
littlep82: calls 4800
EspBju: folds 
vikim08: folds 
*** FLOP *** [4c Ad Th]
heuler27: bets 6000
littlep82: folds 
Uncalled bet (6000) returned to heuler27
heuler27 collected 12750 from pot
heuler27: doesn't show hand 
*** SUMMARY ***
Total pot 12750 | Rake 0 
Board [4c Ad Th]
Seat 1: EspBju (small blind) folded before Flop
Seat 2: vikim08 (big blind) folded before Flop
Seat 3: heuler27 collected (12750)
Seat 4: londrino folded before Flop (didn't bet)
Seat 5: Exit Shikari folded before Flop (didn't bet)
Seat 6: Mr.Skapone folded before Flop (didn't bet)
Seat 7: willem.lodt folded before Flop (didn't bet)
Seat 8: malik_msk folded before Flop (didn't bet)
Seat 9: littlep82 (button) folded on the Flop



PokerStars Game #69714712691: Tournament #544010396, $20+$2 USD Hold'em No Limit - Level XIX (600/1200) - 2011/10/29 23:27:31 MSK [2011/10/29 15:27:31 ET]
Table '544010396 89' 9-max Seat #1 is the button
Seat 1: EspBju (13934 in chips) 
Seat 2: vikim08 (22624 in chips) 
Seat 3: heuler27 (69817 in chips) 
Seat 4: londrino (49255 in chips) 
Seat 5: Exit Shikari (38885 in chips) 
Seat 6: Mr.Skapone (9853 in chips) 
Seat 7: willem.lodt (30564 in chips) 
Seat 8: malik_msk (22876 in chips) 
Seat 9: littlep82 (5204 in chips) 
EspBju: posts the ante 150
vikim08: posts the ante 150
heuler27: posts the ante 150
londrino: posts the ante 150
Exit Shikari: posts the ante 150
Mr.Skapone: posts the ante 150
willem.lodt: posts the ante 150
malik_msk: posts the ante 150
littlep82: posts the ante 150
vikim08: posts small blind 600
heuler27: posts big blind 1200
*** HOLE CARDS ***
Dealt to malik_msk [8d Jd]
londrino: folds 
Exit Shikari: raises 1200 to 2400
Mr.Skapone: folds 
willem.lodt: folds 
malik_msk: folds 
littlep82: folds 
EspBju: folds 
vikim08: folds 
heuler27: folds 
Uncalled bet (1200) returned to Exit Shikari
Exit Shikari collected 4350 from pot
Exit Shikari: doesn't show hand 
*** SUMMARY ***
Total pot 4350 | Rake 0 
Seat 1: EspBju (button) folded before Flop (didn't bet)
Seat 2: vikim08 (small blind) folded before Flop
Seat 3: heuler27 (big blind) folded before Flop
Seat 4: londrino folded before Flop (didn't bet)
Seat 5: Exit Shikari collected (4350)
Seat 6: Mr.Skapone folded before Flop (didn't bet)
Seat 7: willem.lodt folded before Flop (didn't bet)
Seat 8: malik_msk folded before Flop (didn't bet)
Seat 9: littlep82 folded before Flop (didn't bet)



PokerStars Game #69714750938: Tournament #544010396, $20+$2 USD Hold'em No Limit - Level XIX (600/1200) - 2011/10/29 23:28:11 MSK [2011/10/29 15:28:11 ET]
Table '544010396 89' 9-max Seat #2 is the button
Seat 1: EspBju (13784 in chips) 
Seat 2: vikim08 (21874 in chips) 
Seat 3: heuler27 (68467 in chips) 
Seat 4: londrino (49105 in chips) 
Seat 5: Exit Shikari (41885 in chips) 
Seat 6: Mr.Skapone (9703 in chips) 
Seat 7: willem.lodt (30414 in chips) 
Seat 8: malik_msk (22726 in chips) 
Seat 9: littlep82 (5054 in chips) 
EspBju: posts the ante 150
vikim08: posts the ante 150
heuler27: posts the ante 150
londrino: posts the ante 150
Exit Shikari: posts the ante 150
Mr.Skapone: posts the ante 150
willem.lodt: posts the ante 150
malik_msk: posts the ante 150
littlep82: posts the ante 150
heuler27: posts small blind 600
londrino: posts big blind 1200
*** HOLE CARDS ***
Dealt to malik_msk [4c Kd]
Exit Shikari: calls 1200
Mr.Skapone: folds 
willem.lodt: folds 
malik_msk: folds 
littlep82: folds 
EspBju: raises 1800 to 3000
vikim08: folds 
heuler27: folds 
londrino: calls 1800
Exit Shikari: raises 4200 to 7200
EspBju: calls 4200
londrino: folds 
*** FLOP *** [Js Th Jc]
Exit Shikari: bets 3600
EspBju: raises 2834 to 6434 and is all-in
Exit Shikari: calls 2834
*** TURN *** [Js Th Jc] [7s]
*** RIVER *** [Js Th Jc 7s] [4d]
*** SHOW DOWN ***
Exit Shikari: shows [Ad Ah] (two pair, Aces and Jacks)
EspBju: shows [Qs Qc] (two pair, Queens and Jacks)
Exit Shikari collected 32218 from pot
EspBju finished the tournament in 281st place and received $54.75.
4kinghellll is connected 
*** SUMMARY ***
Total pot 32218 | Rake 0 
Board [Js Th Jc 7s 4d]
Seat 1: EspBju showed [Qs Qc] and lost with two pair, Queens and Jacks
Seat 2: vikim08 (button) folded before Flop (didn't bet)
Seat 3: heuler27 (small blind) folded before Flop
Seat 4: londrino (big blind) folded before Flop
Seat 5: Exit Shikari showed [Ad Ah] and won (32218) with two pair, Aces and Jacks
Seat 6: Mr.Skapone folded before Flop (didn't bet)
Seat 7: willem.lodt folded before Flop (didn't bet)
Seat 8: malik_msk folded before Flop (didn't bet)
Seat 9: littlep82 folded before Flop (didn't bet)



PokerStars Game #69714826185: Tournament #544010396, $20+$2 USD Hold'em No Limit - Level XIX (600/1200) - 2011/10/29 23:29:31 MSK [2011/10/29 15:29:31 ET]
Table '544010396 89' 9-max Seat #3 is the button
Seat 1: 4kinghellll (26954 in chips) 
Seat 2: vikim08 (21724 in chips) 
Seat 3: heuler27 (67717 in chips) 
Seat 4: londrino (45955 in chips) 
Seat 5: Exit Shikari (60319 in chips) 
Seat 6: Mr.Skapone (9553 in chips) 
Seat 7: willem.lodt (30264 in chips) 
Seat 8: malik_msk (22576 in chips) 
Seat 9: littlep82 (4904 in chips) 
4kinghellll: posts the ante 150
vikim08: posts the ante 150
heuler27: posts the ante 150
londrino: posts the ante 150
Exit Shikari: posts the ante 150
Mr.Skapone: posts the ante 150
willem.lodt: posts the ante 150
malik_msk: posts the ante 150
littlep82: posts the ante 150
londrino: posts small blind 600
Exit Shikari: posts big blind 1200
*** HOLE CARDS ***
Dealt to malik_msk [Jc Js]
Mr.Skapone: raises 8203 to 9403 and is all-in
willem.lodt: folds 
malik_msk: calls 9403
littlep82: folds 
4kinghellll: folds 
vikim08: folds 
heuler27: folds 
londrino: folds 
Exit Shikari: folds 
*** FLOP *** [8s Jd 8d]
*** TURN *** [8s Jd 8d] [5h]
*** RIVER *** [8s Jd 8d 5h] [3c]
*** SHOW DOWN ***
Mr.Skapone: shows [Ad 6h] (a pair of Eights)
malik_msk: shows [Jc Js] (a full house, Jacks full of Eights)
malik_msk collected 21956 from pot
Mr.Skapone finished the tournament in 277th place and received $54.75.
*** SUMMARY ***
Total pot 21956 | Rake 0 
Board [8s Jd 8d 5h 3c]
Seat 1: 4kinghellll folded before Flop (didn't bet)
Seat 2: vikim08 folded before Flop (didn't bet)
Seat 3: heuler27 (button) folded before Flop (didn't bet)
Seat 4: londrino (small blind) folded before Flop
Seat 5: Exit Shikari (big blind) folded before Flop
Seat 6: Mr.Skapone showed [Ad 6h] and lost with a pair of Eights
Seat 7: willem.lodt folded before Flop (didn't bet)
Seat 8: malik_msk showed [Jc Js] and won (21956) with a full house, Jacks full of Eights
Seat 9: littlep82 folded before Flop (didn't bet)



PokerStars Game #69714853920: Tournament #544010396, $20+$2 USD Hold'em No Limit - Level XIX (600/1200) - 2011/10/29 23:29:57 MSK [2011/10/29 15:29:57 ET]
Table '544010396 89' 9-max Seat #4 is the button
Seat 1: 4kinghellll (26804 in chips) 
Seat 2: vikim08 (21574 in chips) 
Seat 3: heuler27 (67567 in chips) 
Seat 4: londrino (45205 in chips) 
Seat 5: Exit Shikari (58969 in chips) 
Seat 7: willem.lodt (30114 in chips) 
Seat 8: malik_msk (34979 in chips) 
Seat 9: littlep82 (4754 in chips) 
4kinghellll: posts the ante 150
vikim08: posts the ante 150
heuler27: posts the ante 150
londrino: posts the ante 150
Exit Shikari: posts the ante 150
willem.lodt: posts the ante 150
malik_msk: posts the ante 150
littlep82: posts the ante 150
Exit Shikari: posts small blind 600
willem.lodt: posts big blind 1200
*** HOLE CARDS ***
Dealt to malik_msk [8s Ad]
malik_msk: folds 
littlep82: folds 
4kinghellll: folds 
vikim08: folds 
heuler27: raises 3600 to 4800
londrino: folds 
Exit Shikari: folds 
willem.lodt: raises 4800 to 9600
heuler27: calls 4800
*** FLOP *** [2c Th 3c]
willem.lodt: bets 9600
heuler27: calls 9600
*** TURN *** [2c Th 3c] [8d]
willem.lodt: bets 10764 and is all-in
heuler27: calls 10764
peterw80 is connected 
*** RIVER *** [2c Th 3c 8d] [3s]
*** SHOW DOWN ***
willem.lodt: shows [6h 6c] (two pair, Sixes and Threes)
heuler27: shows [Jc Ac] (a pair of Threes)
willem.lodt collected 61728 from pot
*** SUMMARY ***
Total pot 61728 | Rake 0 
Board [2c Th 3c 8d 3s]
Seat 1: 4kinghellll folded before Flop (didn't bet)
Seat 2: vikim08 folded before Flop (didn't bet)
Seat 3: heuler27 showed [Jc Ac] and lost with a pair of Threes
Seat 4: londrino (button) folded before Flop (didn't bet)
Seat 5: Exit Shikari (small blind) folded before Flop
Seat 7: willem.lodt (big blind) showed [6h 6c] and won (61728) with two pair, Sixes and Threes
Seat 8: malik_msk folded before Flop (didn't bet)
Seat 9: littlep82 folded before Flop (didn't bet)



PokerStars Game #69714921816: Tournament #544010396, $20+$2 USD Hold'em No Limit - Level XIX (600/1200) - 2011/10/29 23:31:01 MSK [2011/10/29 15:31:01 ET]
Table '544010396 89' 9-max Seat #5 is the button
Seat 1: 4kinghellll (26654 in chips) 
Seat 2: vikim08 (21424 in chips) 
Seat 3: heuler27 (37453 in chips) 
Seat 4: londrino (45055 in chips) 
Seat 5: Exit Shikari (58219 in chips) 
Seat 6: peterw80 (28439 in chips) out of hand (moved from another table into small blind)
Seat 7: willem.lodt (61728 in chips) 
Seat 8: malik_msk (34829 in chips) 
Seat 9: littlep82 (4604 in chips) 
4kinghellll: posts the ante 150
vikim08: posts the ante 150
heuler27: posts the ante 150
londrino: posts the ante 150
Exit Shikari: posts the ante 150
willem.lodt: posts the ante 150
malik_msk: posts the ante 150
littlep82: posts the ante 150
willem.lodt: posts small blind 600
malik_msk: posts big blind 1200
*** HOLE CARDS ***
Dealt to malik_msk [2c 8s]
littlep82: folds 
4kinghellll: folds 
vikim08: folds 
heuler27: folds 
londrino: folds 
Exit Shikari: folds 
willem.lodt: calls 600
malik_msk: checks 
*** FLOP *** [Kc As 2d]
willem.lodt: checks 
malik_msk: bets 2400
willem.lodt: folds 
Uncalled bet (2400) returned to malik_msk
malik_msk collected 3600 from pot
malik_msk: doesn't show hand 
*** SUMMARY ***
Total pot 3600 | Rake 0 
Board [Kc As 2d]
Seat 1: 4kinghellll folded before Flop (didn't bet)
Seat 2: vikim08 folded before Flop (didn't bet)
Seat 3: heuler27 folded before Flop (didn't bet)
Seat 4: londrino folded before Flop (didn't bet)
Seat 5: Exit Shikari (button) folded before Flop (didn't bet)
Seat 7: willem.lodt (small blind) folded on the Flop
Seat 8: malik_msk (big blind) collected (3600)
Seat 9: littlep82 folded before Flop (didn't bet)



PokerStars Game #69714972422: Tournament #544010396, $20+$2 USD Hold'em No Limit - Level XIX (600/1200) - 2011/10/29 23:31:49 MSK [2011/10/29 15:31:49 ET]
Table '544010396 89' 9-max Seat #7 is the button
Seat 1: 4kinghellll (26504 in chips) 
Seat 2: vikim08 (21274 in chips) 
Seat 3: heuler27 (37303 in chips) 
Seat 4: londrino (44905 in chips) 
Seat 5: Exit Shikari (58069 in chips) 
Seat 6: peterw80 (28439 in chips) 
Seat 7: willem.lodt (60378 in chips) 
Seat 8: malik_msk (37079 in chips) 
Seat 9: littlep82 (4454 in chips) 
4kinghellll: posts the ante 150
vikim08: posts the ante 150
heuler27: posts the ante 150
londrino: posts the ante 150
Exit Shikari: posts the ante 150
peterw80: posts the ante 150
willem.lodt: posts the ante 150
malik_msk: posts the ante 150
littlep82: posts the ante 150
malik_msk: posts small blind 600
littlep82: posts big blind 1200
*** HOLE CARDS ***
Dealt to malik_msk [Js 9s]
4kinghellll: folds 
vikim08: folds 
heuler27: raises 2400 to 3600
londrino: raises 41155 to 44755 and is all-in
Exit Shikari: folds 
peterw80: folds 
willem.lodt: folds 
malik_msk: folds 
littlep82: folds 
heuler27: folds 
Uncalled bet (41155) returned to londrino
londrino collected 10350 from pot
*** SUMMARY ***
Total pot 10350 | Rake 0 
Seat 1: 4kinghellll folded before Flop (didn't bet)
Seat 2: vikim08 folded before Flop (didn't bet)
Seat 3: heuler27 folded before Flop
Seat 4: londrino collected (10350)
Seat 5: Exit Shikari folded before Flop (didn't bet)
Seat 6: peterw80 folded before Flop (didn't bet)
Seat 7: willem.lodt (button) folded before Flop (didn't bet)
Seat 8: malik_msk (small blind) folded before Flop
Seat 9: littlep82 (big blind) folded before Flop



PokerStars Game #69715042327: Tournament #544010396, $20+$2 USD Hold'em No Limit - Level XX (700/1400) - 2011/10/29 23:32:57 MSK [2011/10/29 15:32:57 ET]
Table '544010396 89' 9-max Seat #8 is the button
Seat 1: 4kinghellll (26354 in chips) 
Seat 2: vikim08 (21124 in chips) 
Seat 3: heuler27 (33553 in chips) 
Seat 4: londrino (51505 in chips) 
Seat 5: Exit Shikari (57919 in chips) 
Seat 6: peterw80 (28289 in chips) 
Seat 7: willem.lodt (60228 in chips) 
Seat 8: malik_msk (36329 in chips) 
Seat 9: littlep82 (3104 in chips) 
4kinghellll: posts the ante 175
vikim08: posts the ante 175
heuler27: posts the ante 175
londrino: posts the ante 175
Exit Shikari: posts the ante 175
peterw80: posts the ante 175
willem.lodt: posts the ante 175
malik_msk: posts the ante 175
littlep82: posts the ante 175
littlep82: posts small blind 700
4kinghellll: posts big blind 1400
*** HOLE CARDS ***
Dealt to malik_msk [Td 9s]
vikim08: folds 
heuler27: folds 
londrino: folds 
Exit Shikari: folds 
peterw80: folds 
willem.lodt: folds 
malik_msk: folds 
littlep82: raises 1529 to 2929 and is all-in
4kinghellll: calls 1529
*** FLOP *** [Qc Jc 2d]
*** TURN *** [Qc Jc 2d] [9d]
*** RIVER *** [Qc Jc 2d 9d] [4s]
*** SHOW DOWN ***
littlep82: shows [Qd Js] (two pair, Queens and Jacks)
4kinghellll: shows [Qh 8d] (a pair of Queens)
littlep82 collected 7433 from pot
*** SUMMARY ***
Total pot 7433 | Rake 0 
Board [Qc Jc 2d 9d 4s]
Seat 1: 4kinghellll (big blind) showed [Qh 8d] and lost with a pair of Queens
Seat 2: vikim08 folded before Flop (didn't bet)
Seat 3: heuler27 folded before Flop (didn't bet)
Seat 4: londrino folded before Flop (didn't bet)
Seat 5: Exit Shikari folded before Flop (didn't bet)
Seat 6: peterw80 folded before Flop (didn't bet)
Seat 7: willem.lodt folded before Flop (didn't bet)
Seat 8: malik_msk (button) folded before Flop (didn't bet)
Seat 9: littlep82 (small blind) showed [Qd Js] and won (7433) with two pair, Queens and Jacks



PokerStars Game #69715098040: Tournament #544010396, $20+$2 USD Hold'em No Limit - Level XX (700/1400) - 2011/10/29 23:33:50 MSK [2011/10/29 15:33:50 ET]
Table '544010396 89' 9-max Seat #9 is the button
Seat 1: 4kinghellll (23250 in chips) 
Seat 2: vikim08 (20949 in chips) 
Seat 3: heuler27 (33378 in chips) 
Seat 4: londrino (51330 in chips) 
Seat 5: Exit Shikari (57744 in chips) 
Seat 6: peterw80 (28114 in chips) 
Seat 7: willem.lodt (60053 in chips) 
Seat 8: malik_msk (36154 in chips) 
Seat 9: littlep82 (7433 in chips) 
4kinghellll: posts the ante 175
vikim08: posts the ante 175
heuler27: posts the ante 175
londrino: posts the ante 175
Exit Shikari: posts the ante 175
peterw80: posts the ante 175
willem.lodt: posts the ante 175
malik_msk: posts the ante 175
littlep82: posts the ante 175
4kinghellll: posts small blind 700
vikim08: posts big blind 1400
*** HOLE CARDS ***
Dealt to malik_msk [Kd 2d]
heuler27: calls 1400
londrino: folds 
Exit Shikari: folds 
peterw80: folds 
willem.lodt: raises 1400 to 2800
malik_msk: folds 
littlep82: calls 2800
4kinghellll: folds 
vikim08: folds 
heuler27: calls 1400
*** FLOP *** [8c 2s 3h]
heuler27: checks 
willem.lodt: bets 5600
littlep82: folds 
heuler27: folds 
Uncalled bet (5600) returned to willem.lodt
willem.lodt collected 12075 from pot
willem.lodt: doesn't show hand 
*** SUMMARY ***
Total pot 12075 | Rake 0 
Board [8c 2s 3h]
Seat 1: 4kinghellll (small blind) folded before Flop
Seat 2: vikim08 (big blind) folded before Flop
Seat 3: heuler27 folded on the Flop
Seat 4: londrino folded before Flop (didn't bet)
Seat 5: Exit Shikari folded before Flop (didn't bet)
Seat 6: peterw80 folded before Flop (didn't bet)
Seat 7: willem.lodt collected (12075)
Seat 8: malik_msk folded before Flop (didn't bet)
Seat 9: littlep82 (button) folded on the Flop



PokerStars Game #69715173140: Tournament #544010396, $20+$2 USD Hold'em No Limit - Level XX (700/1400) - 2011/10/29 23:35:04 MSK [2011/10/29 15:35:04 ET]
Table '544010396 89' 9-max Seat #1 is the button
Seat 1: 4kinghellll (22375 in chips) 
Seat 2: vikim08 (19374 in chips) 
Seat 3: heuler27 (30403 in chips) 
Seat 4: londrino (51155 in chips) 
Seat 5: Exit Shikari (57569 in chips) 
Seat 6: peterw80 (27939 in chips) 
Seat 7: willem.lodt (69153 in chips) 
Seat 8: malik_msk (35979 in chips) 
Seat 9: littlep82 (4458 in chips) 
4kinghellll: posts the ante 175
vikim08: posts the ante 175
heuler27: posts the ante 175
londrino: posts the ante 175
Exit Shikari: posts the ante 175
peterw80: posts the ante 175
willem.lodt: posts the ante 175
malik_msk: posts the ante 175
littlep82: posts the ante 175
vikim08: posts small blind 700
heuler27: posts big blind 1400
*** HOLE CARDS ***
Dealt to malik_msk [Td Jd]
londrino: folds 
Exit Shikari: folds 
peterw80: folds 
willem.lodt: folds 
malik_msk: calls 1400
littlep82: folds 
4kinghellll: folds 
vikim08: calls 700
heuler27: checks 
*** FLOP *** [3c 9h 4s]
vikim08: checks 
heuler27: checks 
malik_msk: checks 
*** TURN *** [3c 9h 4s] [8d]
vikim08: bets 2800
heuler27: folds 
malik_msk: calls 2800
*** RIVER *** [3c 9h 4s 8d] [Ts]
vikim08: checks 
malik_msk: bets 5600
vikim08: folds 
Uncalled bet (5600) returned to malik_msk
malik_msk collected 11375 from pot
malik_msk: doesn't show hand 
*** SUMMARY ***
Total pot 11375 | Rake 0 
Board [3c 9h 4s 8d Ts]
Seat 1: 4kinghellll (button) folded before Flop (didn't bet)
Seat 2: vikim08 (small blind) folded on the River
Seat 3: heuler27 (big blind) folded on the Turn
Seat 4: londrino folded before Flop (didn't bet)
Seat 5: Exit Shikari folded before Flop (didn't bet)
Seat 6: peterw80 folded before Flop (didn't bet)
Seat 7: willem.lodt folded before Flop (didn't bet)
Seat 8: malik_msk collected (11375)
Seat 9: littlep82 folded before Flop (didn't bet)



PokerStars Game #69715291061: Tournament #544010396, $20+$2 USD Hold'em No Limit - Level XX (700/1400) - 2011/10/29 23:36:58 MSK [2011/10/29 15:36:58 ET]
Table '544010396 89' 9-max Seat #2 is the button
Seat 1: 4kinghellll (22200 in chips) 
Seat 2: vikim08 (14999 in chips) 
Seat 3: heuler27 (28828 in chips) 
Seat 4: londrino (50980 in chips) 
Seat 5: Exit Shikari (57394 in chips) 
Seat 6: peterw80 (27764 in chips) 
Seat 7: willem.lodt (68978 in chips) 
Seat 8: malik_msk (42979 in chips) 
Seat 9: littlep82 (4283 in chips) 
4kinghellll: posts the ante 175
vikim08: posts the ante 175
heuler27: posts the ante 175
londrino: posts the ante 175
Exit Shikari: posts the ante 175
peterw80: posts the ante 175
willem.lodt: posts the ante 175
malik_msk: posts the ante 175
littlep82: posts the ante 175
heuler27: posts small blind 700
londrino: posts big blind 1400
*** HOLE CARDS ***
Dealt to malik_msk [3h 5d]
Exit Shikari: folds 
peterw80: folds 
willem.lodt: folds 
malik_msk: folds 
littlep82: raises 2708 to 4108 and is all-in
4kinghellll: raises 17917 to 22025 and is all-in
vikim08: folds 
heuler27: folds 
londrino: folds 
Uncalled bet (17917) returned to 4kinghellll
*** FLOP *** [Kc 4s 6h]
*** TURN *** [Kc 4s 6h] [3s]
*** RIVER *** [Kc 4s 6h 3s] [9d]
*** SHOW DOWN ***
littlep82: shows [Ks Th] (a pair of Kings)
4kinghellll: shows [Tc Ah] (high card Ace)
littlep82 collected 11891 from pot
*** SUMMARY ***
Total pot 11891 | Rake 0 
Board [Kc 4s 6h 3s 9d]
Seat 1: 4kinghellll showed [Tc Ah] and lost with high card Ace
Seat 2: vikim08 (button) folded before Flop (didn't bet)
Seat 3: heuler27 (small blind) folded before Flop
Seat 4: londrino (big blind) folded before Flop
Seat 5: Exit Shikari folded before Flop (didn't bet)
Seat 6: peterw80 folded before Flop (didn't bet)
Seat 7: willem.lodt folded before Flop (didn't bet)
Seat 8: malik_msk folded before Flop (didn't bet)
Seat 9: littlep82 showed [Ks Th] and won (11891) with a pair of Kings



PokerStars Game #69715364866: Tournament #544010396, $20+$2 USD Hold'em No Limit - Level XX (700/1400) - 2011/10/29 23:38:11 MSK [2011/10/29 15:38:11 ET]
Table '544010396 89' 9-max Seat #3 is the button
Seat 1: 4kinghellll (17917 in chips) 
Seat 2: vikim08 (14824 in chips) 
Seat 3: heuler27 (27953 in chips) 
Seat 4: londrino (49405 in chips) 
Seat 5: Exit Shikari (57219 in chips) 
Seat 6: peterw80 (27589 in chips) 
Seat 7: willem.lodt (68803 in chips) 
Seat 8: malik_msk (42804 in chips) 
Seat 9: littlep82 (11891 in chips) 
4kinghellll: posts the ante 175
vikim08: posts the ante 175
heuler27: posts the ante 175
londrino: posts the ante 175
Exit Shikari: posts the ante 175
peterw80: posts the ante 175
willem.lodt: posts the ante 175
malik_msk: posts the ante 175
littlep82: posts the ante 175
londrino: posts small blind 700
Exit Shikari: posts big blind 1400
*** HOLE CARDS ***
Dealt to malik_msk [9c Ad]
peterw80 has timed out
peterw80: folds 
peterw80 is sitting out
peterw80 has returned
willem.lodt: folds 
malik_msk: folds 
littlep82: folds 
4kinghellll: folds 
vikim08: folds 
heuler27: folds 
londrino: calls 700
Exit Shikari: raises 2800 to 4200
londrino: calls 2800
*** FLOP *** [3s Ts Tc]
londrino: checks 
Exit Shikari: bets 4000
londrino: calls 4000
*** TURN *** [3s Ts Tc] [Td]
londrino: checks 
Exit Shikari: checks 
*** RIVER *** [3s Ts Tc Td] [7h]
londrino: checks 
Exit Shikari: checks 
*** SHOW DOWN ***
londrino: shows [8d Kh] (three of a kind, Tens)
Exit Shikari: shows [5c Ah] (three of a kind, Tens - Ace kicker)
Exit Shikari collected 17975 from pot
*** SUMMARY ***
Total pot 17975 | Rake 0 
Board [3s Ts Tc Td 7h]
Seat 1: 4kinghellll folded before Flop (didn't bet)
Seat 2: vikim08 folded before Flop (didn't bet)
Seat 3: heuler27 (button) folded before Flop (didn't bet)
Seat 4: londrino (small blind) showed [8d Kh] and lost with three of a kind, Tens
Seat 5: Exit Shikari (big blind) showed [5c Ah] and won (17975) with three of a kind, Tens
Seat 6: peterw80 folded before Flop (didn't bet)
Seat 7: willem.lodt folded before Flop (didn't bet)
Seat 8: malik_msk folded before Flop (didn't bet)
Seat 9: littlep82 folded before Flop (didn't bet)



PokerStars Game #69715459388: Tournament #544010396, $20+$2 USD Hold'em No Limit - Level XX (700/1400) - 2011/10/29 23:39:47 MSK [2011/10/29 15:39:47 ET]
Table '544010396 89' 9-max Seat #4 is the button
Seat 1: 4kinghellll (17742 in chips) 
Seat 2: vikim08 (14649 in chips) 
Seat 3: heuler27 (27778 in chips) 
Seat 4: londrino (41030 in chips) 
Seat 5: Exit Shikari (66819 in chips) 
Seat 6: peterw80 (27414 in chips) 
Seat 7: willem.lodt (68628 in chips) 
Seat 8: malik_msk (42629 in chips) 
Seat 9: littlep82 (11716 in chips) 
4kinghellll: posts the ante 175
vikim08: posts the ante 175
heuler27: posts the ante 175
londrino: posts the ante 175
Exit Shikari: posts the ante 175
peterw80: posts the ante 175
willem.lodt: posts the ante 175
malik_msk: posts the ante 175
littlep82: posts the ante 175
Exit Shikari: posts small blind 700
peterw80: posts big blind 1400
*** HOLE CARDS ***
Dealt to malik_msk [2s 7s]
willem.lodt: folds 
malik_msk: folds 
littlep82: folds 
4kinghellll: folds 
vikim08: folds 
heuler27: calls 1400
londrino: folds 
Exit Shikari: calls 700
peterw80: checks 
*** FLOP *** [Kc 4s Td]
Exit Shikari: checks 
peterw80: checks 
heuler27: bets 2800
Exit Shikari: calls 2800
peterw80: folds 
*** TURN *** [Kc 4s Td] [7d]
Exit Shikari: bets 5600
heuler27: folds 
Uncalled bet (5600) returned to Exit Shikari
Exit Shikari collected 11375 from pot
Exit Shikari: doesn't show hand 
*** SUMMARY ***
Total pot 11375 | Rake 0 
Board [Kc 4s Td 7d]
Seat 1: 4kinghellll folded before Flop (didn't bet)
Seat 2: vikim08 folded before Flop (didn't bet)
Seat 3: heuler27 folded on the Turn
Seat 4: londrino (button) folded before Flop (didn't bet)
Seat 5: Exit Shikari (small blind) collected (11375)
Seat 6: peterw80 (big blind) folded on the Flop
Seat 7: willem.lodt folded before Flop (didn't bet)
Seat 8: malik_msk folded before Flop (didn't bet)
Seat 9: littlep82 folded before Flop (didn't bet)



PokerStars Game #69715580194: Tournament #544010396, $20+$2 USD Hold'em No Limit - Level XX (700/1400) - 2011/10/29 23:41:51 MSK [2011/10/29 15:41:51 ET]
Table '544010396 89' 9-max Seat #5 is the button
Seat 1: 4kinghellll (17567 in chips) 
Seat 2: vikim08 (14474 in chips) 
Seat 3: heuler27 (23403 in chips) 
Seat 4: londrino (40855 in chips) 
Seat 5: Exit Shikari (73819 in chips) 
Seat 6: peterw80 (25839 in chips) 
Seat 7: willem.lodt (68453 in chips) 
Seat 8: malik_msk (42454 in chips) 
Seat 9: littlep82 (11541 in chips) 
4kinghellll: posts the ante 175
vikim08: posts the ante 175
heuler27: posts the ante 175
londrino: posts the ante 175
Exit Shikari: posts the ante 175
peterw80: posts the ante 175
willem.lodt: posts the ante 175
malik_msk: posts the ante 175
littlep82: posts the ante 175
peterw80: posts small blind 700
willem.lodt: posts big blind 1400
*** HOLE CARDS ***
Dealt to malik_msk [8h 4d]
malik_msk: folds 
littlep82: raises 2800 to 4200
4kinghellll: folds 
vikim08: folds 
heuler27: folds 
londrino: folds 
Exit Shikari: folds 
peterw80: folds 
willem.lodt: folds 
Uncalled bet (2800) returned to littlep82
littlep82 collected 5075 from pot
*** SUMMARY ***
Total pot 5075 | Rake 0 
Seat 1: 4kinghellll folded before Flop (didn't bet)
Seat 2: vikim08 folded before Flop (didn't bet)
Seat 3: heuler27 folded before Flop (didn't bet)
Seat 4: londrino folded before Flop (didn't bet)
Seat 5: Exit Shikari (button) folded before Flop (didn't bet)
Seat 6: peterw80 (small blind) folded before Flop
Seat 7: willem.lodt (big blind) folded before Flop
Seat 8: malik_msk folded before Flop (didn't bet)
Seat 9: littlep82 collected (5075)



PokerStars Game #69715629701: Tournament #544010396, $20+$2 USD Hold'em No Limit - Level XXI (800/1600) - 2011/10/29 23:42:42 MSK [2011/10/29 15:42:42 ET]
Table '544010396 89' 9-max Seat #6 is the button
Seat 1: 4kinghellll (17392 in chips) 
Seat 2: vikim08 (14299 in chips) 
Seat 3: heuler27 (23228 in chips) 
Seat 4: londrino (40680 in chips) 
Seat 5: Exit Shikari (73644 in chips) 
Seat 6: peterw80 (24964 in chips) 
Seat 7: willem.lodt (66878 in chips) 
Seat 8: malik_msk (42279 in chips) 
Seat 9: littlep82 (15041 in chips) 
4kinghellll: posts the ante 200
vikim08: posts the ante 200
heuler27: posts the ante 200
londrino: posts the ante 200
Exit Shikari: posts the ante 200
peterw80: posts the ante 200
willem.lodt: posts the ante 200
malik_msk: posts the ante 200
littlep82: posts the ante 200
willem.lodt: posts small blind 800
malik_msk: posts big blind 1600
*** HOLE CARDS ***
Dealt to malik_msk [9h Kd]
littlep82: folds 
4kinghellll: folds 
vikim08: folds 
heuler27: folds 
londrino: folds 
Exit Shikari: raises 2400 to 4000
peterw80: calls 4000
willem.lodt: folds 
malik_msk: folds 
*** FLOP *** [Ad Jc 3s]
Exit Shikari: bets 3200
peterw80: raises 17564 to 20764 and is all-in
Exit Shikari: folds 
Uncalled bet (17564) returned to peterw80
peterw80 collected 18600 from pot
*** SUMMARY ***
Total pot 18600 | Rake 0 
Board [Ad Jc 3s]
Seat 1: 4kinghellll folded before Flop (didn't bet)
Seat 2: vikim08 folded before Flop (didn't bet)
Seat 3: heuler27 folded before Flop (didn't bet)
Seat 4: londrino folded before Flop (didn't bet)
Seat 5: Exit Shikari folded on the Flop
Seat 6: peterw80 (button) collected (18600)
Seat 7: willem.lodt (small blind) folded before Flop
Seat 8: malik_msk (big blind) folded before Flop
Seat 9: littlep82 folded before Flop (didn't bet)



PokerStars Game #69715730104: Tournament #544010396, $20+$2 USD Hold'em No Limit - Level XXI (800/1600) - 2011/10/29 23:44:27 MSK [2011/10/29 15:44:27 ET]
Table '544010396 89' 9-max Seat #7 is the button
Seat 1: 4kinghellll (17192 in chips) 
Seat 2: vikim08 (14099 in chips) 
Seat 3: heuler27 (23028 in chips) 
Seat 4: londrino (40480 in chips) 
Seat 5: Exit Shikari (66244 in chips) 
Seat 6: peterw80 (36164 in chips) 
Seat 7: willem.lodt (65878 in chips) 
Seat 8: malik_msk (40479 in chips) 
Seat 9: littlep82 (14841 in chips) 
4kinghellll: posts the ante 200
vikim08: posts the ante 200
heuler27: posts the ante 200
londrino: posts the ante 200
Exit Shikari: posts the ante 200
peterw80: posts the ante 200
willem.lodt: posts the ante 200
malik_msk: posts the ante 200
littlep82: posts the ante 200
malik_msk: posts small blind 800
littlep82: posts big blind 1600
*** HOLE CARDS ***
Dealt to malik_msk [6s 7d]
4kinghellll: folds 
vikim08: folds 
heuler27: raises 3200 to 4800
londrino: folds 
Exit Shikari: folds 
peterw80: folds 
willem.lodt: folds 
malik_msk: folds 
littlep82: folds 
Uncalled bet (3200) returned to heuler27
heuler27 collected 5800 from pot
heuler27: doesn't show hand 
*** SUMMARY ***
Total pot 5800 | Rake 0 
Seat 1: 4kinghellll folded before Flop (didn't bet)
Seat 2: vikim08 folded before Flop (didn't bet)
Seat 3: heuler27 collected (5800)
Seat 4: londrino folded before Flop (didn't bet)
Seat 5: Exit Shikari folded before Flop (didn't bet)
Seat 6: peterw80 folded before Flop (didn't bet)
Seat 7: willem.lodt (button) folded before Flop (didn't bet)
Seat 8: malik_msk (small blind) folded before Flop
Seat 9: littlep82 (big blind) folded before Flop



PokerStars Game #69715781799: Tournament #544010396, $20+$2 USD Hold'em No Limit - Level XXI (800/1600) - 2011/10/29 23:45:21 MSK [2011/10/29 15:45:21 ET]
Table '544010396 89' 9-max Seat #8 is the button
Seat 1: 4kinghellll (16992 in chips) 
Seat 2: vikim08 (13899 in chips) 
Seat 3: heuler27 (27028 in chips) 
Seat 4: londrino (40280 in chips) 
Seat 5: Exit Shikari (66044 in chips) 
Seat 6: peterw80 (35964 in chips) 
Seat 7: willem.lodt (65678 in chips) 
Seat 8: malik_msk (39479 in chips) 
Seat 9: littlep82 (13041 in chips) 
4kinghellll: posts the ante 200
vikim08: posts the ante 200
heuler27: posts the ante 200
londrino: posts the ante 200
Exit Shikari: posts the ante 200
peterw80: posts the ante 200
willem.lodt: posts the ante 200
malik_msk: posts the ante 200
littlep82: posts the ante 200
littlep82: posts small blind 800
4kinghellll: posts big blind 1600
*** HOLE CARDS ***
Dealt to malik_msk [Kc 3h]
vikim08: folds 
heuler27: folds 
londrino: folds 
Exit Shikari: folds 
peterw80: folds 
willem.lodt: folds 
malik_msk: folds 
littlep82: folds 
Uncalled bet (800) returned to 4kinghellll
4kinghellll collected 3400 from pot
4kinghellll: doesn't show hand 
*** SUMMARY ***
Total pot 3400 | Rake 0 
Seat 1: 4kinghellll (big blind) collected (3400)
Seat 2: vikim08 folded before Flop (didn't bet)
Seat 3: heuler27 folded before Flop (didn't bet)
Seat 4: londrino folded before Flop (didn't bet)
Seat 5: Exit Shikari folded before Flop (didn't bet)
Seat 6: peterw80 folded before Flop (didn't bet)
Seat 7: willem.lodt folded before Flop (didn't bet)
Seat 8: malik_msk (button) folded before Flop (didn't bet)
Seat 9: littlep82 (small blind) folded before Flop



PokerStars Game #69715864615: Tournament #544010396, $20+$2 USD Hold'em No Limit - Level XXI (800/1600) - 2011/10/29 23:46:48 MSK [2011/10/29 15:46:48 ET]
Table '544010396 89' 9-max Seat #9 is the button
Seat 1: 4kinghellll (19392 in chips) 
Seat 2: vikim08 (13699 in chips) 
Seat 3: heuler27 (26828 in chips) 
Seat 4: londrino (40080 in chips) 
Seat 5: Exit Shikari (65844 in chips) 
Seat 6: peterw80 (35764 in chips) 
Seat 7: willem.lodt (65478 in chips) 
Seat 8: malik_msk (39279 in chips) 
Seat 9: littlep82 (12041 in chips) 
4kinghellll: posts the ante 200
vikim08: posts the ante 200
heuler27: posts the ante 200
londrino: posts the ante 200
Exit Shikari: posts the ante 200
peterw80: posts the ante 200
willem.lodt: posts the ante 200
malik_msk: posts the ante 200
littlep82: posts the ante 200
4kinghellll: posts small blind 800
vikim08: posts big blind 1600
*** HOLE CARDS ***
Dealt to malik_msk [7c 4d]
heuler27: folds 
londrino: folds 
Exit Shikari: folds 
peterw80: folds 
willem.lodt: folds 
malik_msk: folds 
littlep82: folds 
4kinghellll: raises 17592 to 19192 and is all-in
vikim08: folds 
Uncalled bet (17592) returned to 4kinghellll
4kinghellll collected 5000 from pot
4kinghellll: doesn't show hand 
*** SUMMARY ***
Total pot 5000 | Rake 0 
Seat 1: 4kinghellll (small blind) collected (5000)
Seat 2: vikim08 (big blind) folded before Flop
Seat 3: heuler27 folded before Flop (didn't bet)
Seat 4: londrino folded before Flop (didn't bet)
Seat 5: Exit Shikari folded before Flop (didn't bet)
Seat 6: peterw80 folded before Flop (didn't bet)
Seat 7: willem.lodt folded before Flop (didn't bet)
Seat 8: malik_msk folded before Flop (didn't bet)
Seat 9: littlep82 (button) folded before Flop (didn't bet)



PokerStars Game #69715919876: Tournament #544010396, $20+$2 USD Hold'em No Limit - Level XXI (800/1600) - 2011/10/29 23:47:45 MSK [2011/10/29 15:47:45 ET]
Table '544010396 89' 9-max Seat #1 is the button
Seat 1: 4kinghellll (22592 in chips) 
Seat 2: vikim08 (11899 in chips) 
Seat 3: heuler27 (26628 in chips) 
Seat 4: londrino (39880 in chips) 
Seat 5: Exit Shikari (65644 in chips) 
Seat 6: peterw80 (35564 in chips) 
Seat 7: willem.lodt (65278 in chips) 
Seat 8: malik_msk (39079 in chips) 
Seat 9: littlep82 (11841 in chips) 
4kinghellll: posts the ante 200
vikim08: posts the ante 200
heuler27: posts the ante 200
londrino: posts the ante 200
Exit Shikari: posts the ante 200
peterw80: posts the ante 200
willem.lodt: posts the ante 200
malik_msk: posts the ante 200
littlep82: posts the ante 200
vikim08: posts small blind 800
heuler27: posts big blind 1600
*** HOLE CARDS ***
Dealt to malik_msk [2c Ks]
londrino: folds 
Exit Shikari: folds 
peterw80: folds 
willem.lodt: folds 
malik_msk: folds 
littlep82: folds 
4kinghellll: folds 
vikim08: raises 10099 to 11699 and is all-in
heuler27: folds 
Uncalled bet (10099) returned to vikim08
vikim08 collected 5000 from pot
*** SUMMARY ***
Total pot 5000 | Rake 0 
Seat 1: 4kinghellll (button) folded before Flop (didn't bet)
Seat 2: vikim08 (small blind) collected (5000)
Seat 3: heuler27 (big blind) folded before Flop
Seat 4: londrino folded before Flop (didn't bet)
Seat 5: Exit Shikari folded before Flop (didn't bet)
Seat 6: peterw80 folded before Flop (didn't bet)
Seat 7: willem.lodt folded before Flop (didn't bet)
Seat 8: malik_msk folded before Flop (didn't bet)
Seat 9: littlep82 folded before Flop (didn't bet)



PokerStars Game #69715958938: Tournament #544010396, $20+$2 USD Hold'em No Limit - Level XXI (800/1600) - 2011/10/29 23:48:26 MSK [2011/10/29 15:48:26 ET]
Table '544010396 89' 9-max Seat #2 is the button
Seat 1: 4kinghellll (22392 in chips) 
Seat 2: vikim08 (15099 in chips) 
Seat 3: heuler27 (24828 in chips) 
Seat 4: londrino (39680 in chips) 
Seat 5: Exit Shikari (65444 in chips) 
Seat 6: peterw80 (35364 in chips) 
Seat 7: willem.lodt (65078 in chips) 
Seat 8: malik_msk (38879 in chips) 
Seat 9: littlep82 (11641 in chips) 
4kinghellll: posts the ante 200
vikim08: posts the ante 200
heuler27: posts the ante 200
londrino: posts the ante 200
Exit Shikari: posts the ante 200
peterw80: posts the ante 200
willem.lodt: posts the ante 200
malik_msk: posts the ante 200
littlep82: posts the ante 200
heuler27: posts small blind 800
londrino: posts big blind 1600
*** HOLE CARDS ***
Dealt to malik_msk [Jh Tc]
Exit Shikari: folds 
peterw80 has timed out
peterw80: folds 
peterw80 is sitting out
peterw80 has returned
willem.lodt: raises 1600 to 3200
malik_msk: calls 3200
littlep82: folds 
4kinghellll: folds 
vikim08: folds 
heuler27: folds 
londrino: folds 
*** FLOP *** [7s As 9d]
willem.lodt: bets 1600
malik_msk: calls 1600
*** TURN *** [7s As 9d] [6h]
willem.lodt: bets 3200
malik_msk: calls 3200
*** RIVER *** [7s As 9d 6h] [Th]
willem.lodt: checks 
malik_msk: bets 14400
willem.lodt: folds 
Uncalled bet (14400) returned to malik_msk
malik_msk collected 20200 from pot
malik_msk: doesn't show hand 
*** SUMMARY ***
Total pot 20200 | Rake 0 
Board [7s As 9d 6h Th]
Seat 1: 4kinghellll folded before Flop (didn't bet)
Seat 2: vikim08 (button) folded before Flop (didn't bet)
Seat 3: heuler27 (small blind) folded before Flop
Seat 4: londrino (big blind) folded before Flop
Seat 5: Exit Shikari folded before Flop (didn't bet)
Seat 6: peterw80 folded before Flop (didn't bet)
Seat 7: willem.lodt folded on the River
Seat 8: malik_msk collected (20200)
Seat 9: littlep82 folded before Flop (didn't bet)



PokerStars Game #69716103041: Tournament #544010396, $20+$2 USD Hold'em No Limit - Level XXI (800/1600) - 2011/10/29 23:51:01 MSK [2011/10/29 15:51:01 ET]
Table '544010396 89' 9-max Seat #3 is the button
Seat 1: 4kinghellll (22192 in chips) 
Seat 2: vikim08 (14899 in chips) 
Seat 3: heuler27 (23828 in chips) 
Seat 4: londrino (37880 in chips) 
Seat 5: Exit Shikari (65244 in chips) 
Seat 6: peterw80 (35164 in chips) 
Seat 7: willem.lodt (56878 in chips) 
Seat 8: malik_msk (50879 in chips) 
Seat 9: littlep82 (11441 in chips) 
4kinghellll: posts the ante 200
vikim08: posts the ante 200
heuler27: posts the ante 200
londrino: posts the ante 200
Exit Shikari: posts the ante 200
peterw80: posts the ante 200
willem.lodt: posts the ante 200
malik_msk: posts the ante 200
littlep82: posts the ante 200
londrino: posts small blind 800
Exit Shikari: posts big blind 1600
*** HOLE CARDS ***
Dealt to malik_msk [Kh Ac]
peterw80: folds 
willem.lodt: folds 
malik_msk: raises 1600 to 3200
littlep82: calls 3200
4kinghellll: folds 
vikim08: folds 
heuler27: folds 
londrino: folds 
Exit Shikari: calls 1600
*** FLOP *** [9c Qd Js]
Exit Shikari: checks 
malik_msk: checks 
littlep82: checks 
*** TURN *** [9c Qd Js] [8s]
Exit Shikari: checks 
malik_msk: checks 
littlep82: checks 
*** RIVER *** [9c Qd Js 8s] [5s]
Exit Shikari: bets 4800
malik_msk: folds 
littlep82: folds 
Uncalled bet (4800) returned to Exit Shikari
Exit Shikari collected 12200 from pot
Exit Shikari: doesn't show hand 
*** SUMMARY ***
Total pot 12200 | Rake 0 
Board [9c Qd Js 8s 5s]
Seat 1: 4kinghellll folded before Flop (didn't bet)
Seat 2: vikim08 folded before Flop (didn't bet)
Seat 3: heuler27 (button) folded before Flop (didn't bet)
Seat 4: londrino (small blind) folded before Flop
Seat 5: Exit Shikari (big blind) collected (12200)
Seat 6: peterw80 folded before Flop (didn't bet)
Seat 7: willem.lodt folded before Flop (didn't bet)
Seat 8: malik_msk folded on the River
Seat 9: littlep82 folded on the River



PokerStars Game #69716187265: Tournament #544010396, $20+$2 USD Hold'em No Limit - Level XXI (800/1600) - 2011/10/29 23:52:32 MSK [2011/10/29 15:52:32 ET]
Table '544010396 89' 9-max Seat #4 is the button
Seat 1: 4kinghellll (21992 in chips) 
Seat 2: vikim08 (14699 in chips) 
Seat 3: heuler27 (23628 in chips) 
Seat 4: londrino (36880 in chips) 
Seat 5: Exit Shikari (74044 in chips) 
Seat 6: peterw80 (34964 in chips) 
Seat 7: willem.lodt (56678 in chips) 
Seat 8: malik_msk (47479 in chips) 
Seat 9: littlep82 (8041 in chips) 
4kinghellll: posts the ante 200
vikim08: posts the ante 200
heuler27: posts the ante 200
londrino: posts the ante 200
Exit Shikari: posts the ante 200
peterw80: posts the ante 200
willem.lodt: posts the ante 200
malik_msk: posts the ante 200
littlep82: posts the ante 200
Exit Shikari: posts small blind 800
peterw80: posts big blind 1600
*** HOLE CARDS ***
Dealt to malik_msk [6h 3c]
willem.lodt: folds 
malik_msk: folds 
littlep82: folds 
4kinghellll: folds 
vikim08: folds 
heuler27: folds 
londrino: raises 4800 to 6400
Exit Shikari: folds 
peterw80: folds 
Uncalled bet (4800) returned to londrino
londrino collected 5800 from pot
*** SUMMARY ***
Total pot 5800 | Rake 0 
Seat 1: 4kinghellll folded before Flop (didn't bet)
Seat 2: vikim08 folded before Flop (didn't bet)
Seat 3: heuler27 folded before Flop (didn't bet)
Seat 4: londrino (button) collected (5800)
Seat 5: Exit Shikari (small blind) folded before Flop
Seat 6: peterw80 (big blind) folded before Flop
Seat 7: willem.lodt folded before Flop (didn't bet)
Seat 8: malik_msk folded before Flop (didn't bet)
Seat 9: littlep82 folded before Flop (didn't bet)



PokerStars Game #69716238759: Tournament #544010396, $20+$2 USD Hold'em No Limit - Level XXII (900/1800) - 2011/10/29 23:53:28 MSK [2011/10/29 15:53:28 ET]
Table '544010396 89' 9-max Seat #5 is the button
Seat 1: 4kinghellll (21792 in chips) 
Seat 2: vikim08 (14499 in chips) 
Seat 3: heuler27 (23428 in chips) 
Seat 4: londrino (40880 in chips) 
Seat 5: Exit Shikari (73044 in chips) 
Seat 6: peterw80 (33164 in chips) 
Seat 7: willem.lodt (56478 in chips) 
Seat 8: malik_msk (47279 in chips) 
Seat 9: littlep82 (7841 in chips) 
4kinghellll: posts the ante 225
vikim08: posts the ante 225
heuler27: posts the ante 225
londrino: posts the ante 225
Exit Shikari: posts the ante 225
peterw80: posts the ante 225
willem.lodt: posts the ante 225
malik_msk: posts the ante 225
littlep82: posts the ante 225
peterw80: posts small blind 900
willem.lodt: posts big blind 1800
*** HOLE CARDS ***
Dealt to malik_msk [Ks Jc]
malik_msk: calls 1800
littlep82: folds 
4kinghellll: folds 
vikim08: folds 
heuler27: folds 
londrino: folds 
Exit Shikari: folds 
peterw80: calls 900
willem.lodt: checks 
*** FLOP *** [Qs Ah 7d]
peterw80 has timed out
peterw80: checks 
willem.lodt: checks 
malik_msk: checks 
*** TURN *** [Qs Ah 7d] [4d]
peterw80: bets 1800
willem.lodt: raises 1800 to 3600
malik_msk: folds 
peterw80: calls 1800
*** RIVER *** [Qs Ah 7d 4d] [Kd]
peterw80: checks 
willem.lodt: checks 
*** SHOW DOWN ***
peterw80: shows [As 2s] (a pair of Aces)
willem.lodt: shows [Qd 7c] (two pair, Queens and Sevens)
willem.lodt collected 14625 from pot
*** SUMMARY ***
Total pot 14625 | Rake 0 
Board [Qs Ah 7d 4d Kd]
Seat 1: 4kinghellll folded before Flop (didn't bet)
Seat 2: vikim08 folded before Flop (didn't bet)
Seat 3: heuler27 folded before Flop (didn't bet)
Seat 4: londrino folded before Flop (didn't bet)
Seat 5: Exit Shikari (button) folded before Flop (didn't bet)
Seat 6: peterw80 (small blind) showed [As 2s] and lost with a pair of Aces
Seat 7: willem.lodt (big blind) showed [Qd 7c] and won (14625) with two pair, Queens and Sevens
Seat 8: malik_msk folded on the Turn
Seat 9: littlep82 folded before Flop (didn't bet)



PokerStars Game #69716584100: Tournament #544010396, $20+$2 USD Hold'em No Limit - Level XXII (900/1800) - 2011/10/30 0:01:29 MSK [2011/10/29 16:01:29 ET]
Table '544010396 89' 9-max Seat #6 is the button
Seat 1: 4kinghellll (21567 in chips) 
Seat 2: vikim08 (14274 in chips) 
Seat 3: heuler27 (23203 in chips) 
Seat 4: londrino (40655 in chips) 
Seat 5: Exit Shikari (72819 in chips) 
Seat 6: peterw80 (27539 in chips) 
Seat 7: willem.lodt (65478 in chips) 
Seat 8: malik_msk (45254 in chips) 
Seat 9: littlep82 (7616 in chips) 
4kinghellll: posts the ante 225
vikim08: posts the ante 225
heuler27: posts the ante 225
londrino: posts the ante 225
Exit Shikari: posts the ante 225
peterw80: posts the ante 225
willem.lodt: posts the ante 225
malik_msk: posts the ante 225
littlep82: posts the ante 225
willem.lodt: posts small blind 900
malik_msk: posts big blind 1800
*** HOLE CARDS ***
Dealt to malik_msk [Qh 9s]
littlep82: calls 1800
4kinghellll: folds 
vikim08: folds 
heuler27: folds 
londrino: folds 
Exit Shikari has timed out
Exit Shikari: folds 
Exit Shikari is sitting out
peterw80: folds 
willem.lodt: folds 
malik_msk: checks 
*** FLOP *** [6h 9c Td]
malik_msk: bets 5591
littlep82: calls 5591 and is all-in
*** TURN *** [6h 9c Td] [Jh]
*** RIVER *** [6h 9c Td Jh] [4h]
*** SHOW DOWN ***
malik_msk: shows [Qh 9s] (a pair of Nines)
littlep82: shows [Tc Ad] (a pair of Tens)
littlep82 collected 17707 from pot
*** SUMMARY ***
Total pot 17707 | Rake 0 
Board [6h 9c Td Jh 4h]
Seat 1: 4kinghellll folded before Flop (didn't bet)
Seat 2: vikim08 folded before Flop (didn't bet)
Seat 3: heuler27 folded before Flop (didn't bet)
Seat 4: londrino folded before Flop (didn't bet)
Seat 5: Exit Shikari folded before Flop (didn't bet)
Seat 6: peterw80 (button) folded before Flop (didn't bet)
Seat 7: willem.lodt (small blind) folded before Flop
Seat 8: malik_msk (big blind) showed [Qh 9s] and lost with a pair of Nines
Seat 9: littlep82 showed [Tc Ad] and won (17707) with a pair of Tens



PokerStars Game #69716776741: Tournament #544010396, $20+$2 USD Hold'em No Limit - Level XXII (900/1800) - 2011/10/30 0:04:52 MSK [2011/10/29 16:04:52 ET]
Table '544010396 89' 9-max Seat #7 is the button
Seat 1: 4kinghellll (21342 in chips) 
Seat 2: vikim08 (14049 in chips) 
Seat 3: heuler27 (22978 in chips) 
Seat 4: londrino (40430 in chips) 
Seat 5: Exit Shikari (72594 in chips) is sitting out
Seat 6: peterw80 (27314 in chips) 
Seat 7: willem.lodt (64353 in chips) 
Seat 8: malik_msk (37638 in chips) 
Seat 9: littlep82 (17707 in chips) 
4kinghellll: posts the ante 225
vikim08: posts the ante 225
heuler27: posts the ante 225
londrino: posts the ante 225
Exit Shikari: posts the ante 225
peterw80: posts the ante 225
willem.lodt: posts the ante 225
malik_msk: posts the ante 225
littlep82: posts the ante 225
malik_msk: posts small blind 900
littlep82: posts big blind 1800
*** HOLE CARDS ***
Dealt to malik_msk [Ts Js]
4kinghellll: folds 
vikim08: raises 12024 to 13824 and is all-in
heuler27: folds 
londrino: folds 
Exit Shikari: folds 
peterw80: folds 
willem.lodt: folds 
malik_msk: folds 
littlep82: folds 
Uncalled bet (12024) returned to vikim08
vikim08 collected 6525 from pot
*** SUMMARY ***
Total pot 6525 | Rake 0 
Seat 1: 4kinghellll folded before Flop (didn't bet)
Seat 2: vikim08 collected (6525)
Seat 3: heuler27 folded before Flop (didn't bet)
Seat 4: londrino folded before Flop (didn't bet)
Seat 5: Exit Shikari folded before Flop (didn't bet)
Seat 6: peterw80 folded before Flop (didn't bet)
Seat 7: willem.lodt (button) folded before Flop (didn't bet)
Seat 8: malik_msk (small blind) folded before Flop
Seat 9: littlep82 (big blind) folded before Flop



PokerStars Game #69716832887: Tournament #544010396, $20+$2 USD Hold'em No Limit - Level XXII (900/1800) - 2011/10/30 0:05:49 MSK [2011/10/29 16:05:49 ET]
Table '544010396 89' 9-max Seat #8 is the button
Seat 1: 4kinghellll (21117 in chips) 
Seat 2: vikim08 (18549 in chips) 
Seat 3: heuler27 (22753 in chips) 
Seat 4: londrino (40205 in chips) 
Seat 5: Exit Shikari (72369 in chips) is sitting out
Seat 6: peterw80 (27089 in chips) 
Seat 7: willem.lodt (64128 in chips) 
Seat 8: malik_msk (36513 in chips) 
Seat 9: littlep82 (15682 in chips) 
4kinghellll: posts the ante 225
vikim08: posts the ante 225
heuler27: posts the ante 225
londrino: posts the ante 225
Exit Shikari: posts the ante 225
peterw80: posts the ante 225
willem.lodt: posts the ante 225
malik_msk: posts the ante 225
littlep82: posts the ante 225
littlep82: posts small blind 900
4kinghellll: posts big blind 1800
*** HOLE CARDS ***
Dealt to malik_msk [8h 9h]
vikim08: folds 
heuler27: raises 3600 to 5400
londrino: folds 
Exit Shikari: folds 
peterw80: folds 
willem.lodt: folds 
malik_msk: calls 5400
littlep82: folds 
Exit Shikari has returned
4kinghellll: folds 
*** FLOP *** [Kd 4s Ks]
heuler27: checks 
malik_msk: checks 
*** TURN *** [Kd 4s Ks] [2d]
heuler27: bets 5400
malik_msk: folds 
Uncalled bet (5400) returned to heuler27
heuler27 collected 15525 from pot
heuler27: doesn't show hand 
*** SUMMARY ***
Total pot 15525 | Rake 0 
Board [Kd 4s Ks 2d]
Seat 1: 4kinghellll (big blind) folded before Flop
Seat 2: vikim08 folded before Flop (didn't bet)
Seat 3: heuler27 collected (15525)
Seat 4: londrino folded before Flop (didn't bet)
Seat 5: Exit Shikari folded before Flop (didn't bet)
Seat 6: peterw80 folded before Flop (didn't bet)
Seat 7: willem.lodt folded before Flop (didn't bet)
Seat 8: malik_msk (button) folded on the Turn
Seat 9: littlep82 (small blind) folded before Flop



PokerStars Game #69716914129: Tournament #544010396, $20+$2 USD Hold'em No Limit - Level XXII (900/1800) - 2011/10/30 0:07:13 MSK [2011/10/29 16:07:13 ET]
Table '544010396 89' 9-max Seat #9 is the button
Seat 1: 4kinghellll (19092 in chips) 
Seat 2: vikim08 (18324 in chips) 
Seat 3: heuler27 (32653 in chips) 
Seat 4: londrino (39980 in chips) 
Seat 5: Exit Shikari (72144 in chips) 
Seat 6: peterw80 (26864 in chips) 
Seat 7: willem.lodt (63903 in chips) 
Seat 8: malik_msk (30888 in chips) 
Seat 9: littlep82 (14557 in chips) 
4kinghellll: posts the ante 225
vikim08: posts the ante 225
heuler27: posts the ante 225
londrino: posts the ante 225
Exit Shikari: posts the ante 225
peterw80: posts the ante 225
willem.lodt: posts the ante 225
malik_msk: posts the ante 225
littlep82: posts the ante 225
4kinghellll: posts small blind 900
vikim08: posts big blind 1800
*** HOLE CARDS ***
Dealt to malik_msk [As 2c]
heuler27: folds 
londrino: folds 
Exit Shikari: folds 
peterw80: folds 
willem.lodt: raises 3600 to 5400
malik_msk: folds 
littlep82: folds 
4kinghellll: folds 
vikim08: folds 
Uncalled bet (3600) returned to willem.lodt
willem.lodt collected 6525 from pot
willem.lodt: doesn't show hand 
*** SUMMARY ***
Total pot 6525 | Rake 0 
Seat 1: 4kinghellll (small blind) folded before Flop
Seat 2: vikim08 (big blind) folded before Flop
Seat 3: heuler27 folded before Flop (didn't bet)
Seat 4: londrino folded before Flop (didn't bet)
Seat 5: Exit Shikari folded before Flop (didn't bet)
Seat 6: peterw80 folded before Flop (didn't bet)
Seat 7: willem.lodt collected (6525)
Seat 8: malik_msk folded before Flop (didn't bet)
Seat 9: littlep82 (button) folded before Flop (didn't bet)



PokerStars Game #69716963183: Tournament #544010396, $20+$2 USD Hold'em No Limit - Level XXII (900/1800) - 2011/10/30 0:08:05 MSK [2011/10/29 16:08:05 ET]
Table '544010396 89' 9-max Seat #1 is the button
Seat 1: 4kinghellll (17967 in chips) 
Seat 2: vikim08 (16299 in chips) 
Seat 3: heuler27 (32428 in chips) 
Seat 4: londrino (39755 in chips) 
Seat 5: Exit Shikari (71919 in chips) 
Seat 6: peterw80 (26639 in chips) 
Seat 7: willem.lodt (68403 in chips) 
Seat 8: malik_msk (30663 in chips) 
Seat 9: littlep82 (14332 in chips) 
4kinghellll: posts the ante 225
vikim08: posts the ante 225
heuler27: posts the ante 225
londrino: posts the ante 225
Exit Shikari: posts the ante 225
peterw80: posts the ante 225
willem.lodt: posts the ante 225
malik_msk: posts the ante 225
littlep82: posts the ante 225
vikim08: posts small blind 900
heuler27: posts big blind 1800
*** HOLE CARDS ***
Dealt to malik_msk [2c 9s]
londrino: folds 
Exit Shikari: folds 
peterw80: folds 
willem.lodt: folds 
malik_msk: folds 
littlep82: calls 1800
4kinghellll: raises 3700 to 5500
vikim08: folds 
heuler27: calls 3700
littlep82: calls 3700
*** FLOP *** [Ad 2s 3h]
heuler27: checks 
littlep82: checks 
4kinghellll: bets 12242 and is all-in
heuler27: calls 12242
littlep82: folds 
*** TURN *** [Ad 2s 3h] [Kd]
*** RIVER *** [Ad 2s 3h Kd] [Ac]
*** SHOW DOWN ***
heuler27: shows [As Jc] (three of a kind, Aces)
4kinghellll: shows [Qc 9c] (a pair of Aces)
heuler27 collected 43909 from pot
4kinghellll finished the tournament in 166th place and received $73.00.
*** SUMMARY ***
Total pot 43909 | Rake 0 
Board [Ad 2s 3h Kd Ac]
Seat 1: 4kinghellll (button) showed [Qc 9c] and lost with a pair of Aces
Seat 2: vikim08 (small blind) folded before Flop
Seat 3: heuler27 (big blind) showed [As Jc] and won (43909) with three of a kind, Aces
Seat 4: londrino folded before Flop (didn't bet)
Seat 5: Exit Shikari folded before Flop (didn't bet)
Seat 6: peterw80 folded before Flop (didn't bet)
Seat 7: willem.lodt folded before Flop (didn't bet)
Seat 8: malik_msk folded before Flop (didn't bet)
Seat 9: littlep82 folded on the Flop



PokerStars Game #69717045539: Tournament #544010396, $20+$2 USD Hold'em No Limit - Level XXIII (1000/2000) - 2011/10/30 0:09:33 MSK [2011/10/29 16:09:33 ET]
Table '544010396 89' 9-max Seat #2 is the button
Seat 2: vikim08 (15174 in chips) 
Seat 3: heuler27 (58370 in chips) 
Seat 4: londrino (39530 in chips) 
Seat 5: Exit Shikari (71694 in chips) 
Seat 6: peterw80 (26414 in chips) 
Seat 7: willem.lodt (68178 in chips) 
Seat 8: malik_msk (30438 in chips) 
Seat 9: littlep82 (8607 in chips) 
vikim08: posts the ante 250
heuler27: posts the ante 250
londrino: posts the ante 250
Exit Shikari: posts the ante 250
peterw80: posts the ante 250
willem.lodt: posts the ante 250
malik_msk: posts the ante 250
littlep82: posts the ante 250
heuler27: posts small blind 1000
londrino: posts big blind 2000
*** HOLE CARDS ***
Dealt to malik_msk [7c Js]
Exit Shikari: calls 2000
peterw80: folds 
willem.lodt: folds 
malik_msk: folds 
littlep82: calls 2000
vikim08: calls 2000
heuler27: calls 1000
londrino: checks 
*** FLOP *** [6h 5c Ts]
PunterTHFC is connected 
heuler27: checks 
londrino: checks 
Exit Shikari: bets 4000
littlep82: folds 
vikim08: folds 
heuler27: folds 
londrino: folds 
Uncalled bet (4000) returned to Exit Shikari
Exit Shikari collected 12000 from pot
Exit Shikari: doesn't show hand 
*** SUMMARY ***
Total pot 12000 | Rake 0 
Board [6h 5c Ts]
Seat 2: vikim08 (button) folded on the Flop
Seat 3: heuler27 (small blind) folded on the Flop
Seat 4: londrino (big blind) folded on the Flop
Seat 5: Exit Shikari collected (12000)
Seat 6: peterw80 folded before Flop (didn't bet)
Seat 7: willem.lodt folded before Flop (didn't bet)
Seat 8: malik_msk folded before Flop (didn't bet)
Seat 9: littlep82 folded on the Flop



PokerStars Game #69717132150: Tournament #544010396, $20+$2 USD Hold'em No Limit - Level XXIII (1000/2000) - 2011/10/30 0:11:07 MSK [2011/10/29 16:11:07 ET]
Table '544010396 89' 9-max Seat #3 is the button
Seat 1: PunterTHFC (22668 in chips) 
Seat 2: vikim08 (12924 in chips) 
Seat 3: heuler27 (56120 in chips) 
Seat 4: londrino (37280 in chips) 
Seat 5: Exit Shikari (81444 in chips) 
Seat 6: peterw80 (26164 in chips) 
Seat 7: willem.lodt (67928 in chips) 
Seat 8: malik_msk (30188 in chips) 
Seat 9: littlep82 (6357 in chips) 
PunterTHFC: posts the ante 250
vikim08: posts the ante 250
heuler27: posts the ante 250
londrino: posts the ante 250
Exit Shikari: posts the ante 250
peterw80: posts the ante 250
willem.lodt: posts the ante 250
malik_msk: posts the ante 250
littlep82: posts the ante 250
londrino: posts small blind 1000
Exit Shikari: posts big blind 2000
*** HOLE CARDS ***
Dealt to malik_msk [Td Ts]
peterw80: folds 
willem.lodt: calls 2000
malik_msk: raises 8000 to 10000
littlep82: calls 6107 and is all-in
PunterTHFC: folds 
vikim08: folds 
heuler27: folds 
londrino: folds 
Exit Shikari: folds 
willem.lodt: folds 
Uncalled bet (3893) returned to malik_msk
*** FLOP *** [Ac 4d Js]
*** TURN *** [Ac 4d Js] [3s]
*** RIVER *** [Ac 4d Js 3s] [7s]
*** SHOW DOWN ***
malik_msk: shows [Td Ts] (a pair of Tens)
littlep82: shows [Kh Th] (high card Ace)
malik_msk collected 19464 from pot
littlep82 finished the tournament in 155th place and received $73.00.
*** SUMMARY ***
Total pot 19464 | Rake 0 
Board [Ac 4d Js 3s 7s]
Seat 1: PunterTHFC folded before Flop (didn't bet)
Seat 2: vikim08 folded before Flop (didn't bet)
Seat 3: heuler27 (button) folded before Flop (didn't bet)
Seat 4: londrino (small blind) folded before Flop
Seat 5: Exit Shikari (big blind) folded before Flop
Seat 6: peterw80 folded before Flop (didn't bet)
Seat 7: willem.lodt folded before Flop
Seat 8: malik_msk showed [Td Ts] and won (19464) with a pair of Tens
Seat 9: littlep82 showed [Kh Th] and lost with high card Ace



PokerStars Game #69717202985: Tournament #544010396, $20+$2 USD Hold'em No Limit - Level XXIII (1000/2000) - 2011/10/30 0:12:24 MSK [2011/10/29 16:12:24 ET]
Table '544010396 89' 9-max Seat #4 is the button
Seat 1: PunterTHFC (22418 in chips) 
Seat 2: vikim08 (12674 in chips) 
Seat 3: heuler27 (55870 in chips) 
Seat 4: londrino (36030 in chips) 
Seat 5: Exit Shikari (79194 in chips) 
Seat 6: peterw80 (25914 in chips) 
Seat 7: willem.lodt (65678 in chips) 
Seat 8: malik_msk (43295 in chips) 
PunterTHFC: posts the ante 250
vikim08: posts the ante 250
heuler27: posts the ante 250
londrino: posts the ante 250
Exit Shikari: posts the ante 250
peterw80: posts the ante 250
willem.lodt: posts the ante 250
malik_msk: posts the ante 250
Exit Shikari: posts small blind 1000
peterw80: posts big blind 2000
*** HOLE CARDS ***
Dealt to malik_msk [3d Jh]
willem.lodt: folds 
malik_msk: folds 
PunterTHFC: folds 
vikim08: folds 
heuler27: folds 
londrino: folds 
Exit Shikari: calls 1000
AL3X=PRO is connected 
peterw80: checks 
*** FLOP *** [Qh Kh 6c]
Exit Shikari: bets 4000
peterw80: folds 
Uncalled bet (4000) returned to Exit Shikari
Exit Shikari collected 6000 from pot
Exit Shikari: doesn't show hand 
*** SUMMARY ***
Total pot 6000 | Rake 0 
Board [Qh Kh 6c]
Seat 1: PunterTHFC folded before Flop (didn't bet)
Seat 2: vikim08 folded before Flop (didn't bet)
Seat 3: heuler27 folded before Flop (didn't bet)
Seat 4: londrino (button) folded before Flop (didn't bet)
Seat 5: Exit Shikari (small blind) collected (6000)
Seat 6: peterw80 (big blind) folded on the Flop
Seat 7: willem.lodt folded before Flop (didn't bet)
Seat 8: malik_msk folded before Flop (didn't bet)



PokerStars Game #69717278258: Tournament #544010396, $20+$2 USD Hold'em No Limit - Level XXIII (1000/2000) - 2011/10/30 0:13:47 MSK [2011/10/29 16:13:47 ET]
Table '544010396 89' 9-max Seat #5 is the button
Seat 1: PunterTHFC (22168 in chips) 
Seat 2: vikim08 (12424 in chips) 
Seat 3: heuler27 (55620 in chips) 
Seat 4: londrino (35780 in chips) 
Seat 5: Exit Shikari (82944 in chips) 
Seat 6: peterw80 (23664 in chips) 
Seat 7: willem.lodt (65428 in chips) 
Seat 8: malik_msk (43045 in chips) 
Seat 9: AL3X=PRO (46874 in chips) 
PunterTHFC: posts the ante 250
vikim08: posts the ante 250
heuler27: posts the ante 250
londrino: posts the ante 250
Exit Shikari: posts the ante 250
peterw80: posts the ante 250
willem.lodt: posts the ante 250
malik_msk: posts the ante 250
AL3X=PRO: posts the ante 250
peterw80: posts small blind 1000
willem.lodt: posts big blind 2000
*** HOLE CARDS ***
Dealt to malik_msk [6c Qh]
malik_msk: folds 
AL3X=PRO: folds 
PunterTHFC: folds 
vikim08: folds 
heuler27: raises 4000 to 6000
londrino: folds 
Exit Shikari: folds 
peterw80: folds 
willem.lodt: folds 
Uncalled bet (4000) returned to heuler27
heuler27 collected 7250 from pot
heuler27: doesn't show hand 
*** SUMMARY ***
Total pot 7250 | Rake 0 
Seat 1: PunterTHFC folded before Flop (didn't bet)
Seat 2: vikim08 folded before Flop (didn't bet)
Seat 3: heuler27 collected (7250)
Seat 4: londrino folded before Flop (didn't bet)
Seat 5: Exit Shikari (button) folded before Flop (didn't bet)
Seat 6: peterw80 (small blind) folded before Flop
Seat 7: willem.lodt (big blind) folded before Flop
Seat 8: malik_msk folded before Flop (didn't bet)
Seat 9: AL3X=PRO folded before Flop (didn't bet)



PokerStars Game #69717315943: Tournament #544010396, $20+$2 USD Hold'em No Limit - Level XXIII (1000/2000) - 2011/10/30 0:14:29 MSK [2011/10/29 16:14:29 ET]
Table '544010396 89' 9-max Seat #6 is the button
Seat 1: PunterTHFC (21918 in chips) 
Seat 2: vikim08 (12174 in chips) 
Seat 3: heuler27 (60620 in chips) 
Seat 4: londrino (35530 in chips) 
Seat 5: Exit Shikari (82694 in chips) 
Seat 6: peterw80 (22414 in chips) 
Seat 7: willem.lodt (63178 in chips) 
Seat 8: malik_msk (42795 in chips) 
Seat 9: AL3X=PRO (46624 in chips) 
PunterTHFC: posts the ante 250
vikim08: posts the ante 250
heuler27: posts the ante 250
londrino: posts the ante 250
Exit Shikari: posts the ante 250
peterw80: posts the ante 250
willem.lodt: posts the ante 250
malik_msk: posts the ante 250
AL3X=PRO: posts the ante 250
willem.lodt: posts small blind 1000
malik_msk: posts big blind 2000
*** HOLE CARDS ***
Dealt to malik_msk [Qh As]
AL3X=PRO: raises 2600 to 4600
PunterTHFC: folds 
vikim08: folds 
heuler27: folds 
londrino: raises 30680 to 35280 and is all-in
Exit Shikari: folds 
peterw80: folds 
willem.lodt: folds 
malik_msk: raises 7265 to 42545 and is all-in
AL3X=PRO: folds 
Uncalled bet (7265) returned to malik_msk
*** FLOP *** [7d 5s 9c]
*** TURN *** [7d 5s 9c] [Qc]
*** RIVER *** [7d 5s 9c Qc] [8d]
*** SHOW DOWN ***
malik_msk: shows [Qh As] (a pair of Queens)
londrino: shows [Jh Ah] (high card Ace)
malik_msk collected 78410 from pot
londrino finished the tournament in 146th place and received $73.00.
*** SUMMARY ***
Total pot 78410 | Rake 0 
Board [7d 5s 9c Qc 8d]
Seat 1: PunterTHFC folded before Flop (didn't bet)
Seat 2: vikim08 folded before Flop (didn't bet)
Seat 3: heuler27 folded before Flop (didn't bet)
Seat 4: londrino showed [Jh Ah] and lost with high card Ace
Seat 5: Exit Shikari folded before Flop (didn't bet)
Seat 6: peterw80 (button) folded before Flop (didn't bet)
Seat 7: willem.lodt (small blind) folded before Flop
Seat 8: malik_msk (big blind) showed [Qh As] and won (78410) with a pair of Queens
Seat 9: AL3X=PRO folded before Flop



PokerStars Game #69717415199: Tournament #544010396, $20+$2 USD Hold'em No Limit - Level XXIII (1000/2000) - 2011/10/30 0:16:16 MSK [2011/10/29 16:16:16 ET]
Table '544010396 89' 9-max Seat #7 is the button
Seat 1: PunterTHFC (21668 in chips) 
Seat 2: vikim08 (11924 in chips) 
Seat 3: heuler27 (60370 in chips) 
Seat 5: Exit Shikari (82444 in chips) 
Seat 6: peterw80 (22164 in chips) 
Seat 7: willem.lodt (61928 in chips) 
Seat 8: malik_msk (85675 in chips) 
Seat 9: AL3X=PRO (41774 in chips) 
PunterTHFC: posts the ante 250
vikim08: posts the ante 250
heuler27: posts the ante 250
Exit Shikari: posts the ante 250
peterw80: posts the ante 250
willem.lodt: posts the ante 250
malik_msk: posts the ante 250
AL3X=PRO: posts the ante 250
malik_msk: posts small blind 1000
AL3X=PRO: posts big blind 2000
*** HOLE CARDS ***
Dealt to malik_msk [8h 3s]
PunterTHFC: folds 
vikim08: raises 9674 to 11674 and is all-in
heuler27: calls 11674
adrian_114iz is connected 
Exit Shikari: folds 
peterw80 has timed out
peterw80: folds 
peterw80 is sitting out
willem.lodt: folds 
peterw80 has returned
malik_msk: folds 
AL3X=PRO: folds 
*** FLOP *** [3c Kh Kd]
*** TURN *** [3c Kh Kd] [Jd]
*** RIVER *** [3c Kh Kd Jd] [Ks]
*** SHOW DOWN ***
vikim08: shows [Ac 9s] (three of a kind, Kings)
heuler27: shows [Qs Qh] (a full house, Kings full of Queens)
heuler27 collected 28348 from pot
vikim08 finished the tournament in 143rd place and received $79.09.
*** SUMMARY ***
Total pot 28348 | Rake 0 
Board [3c Kh Kd Jd Ks]
Seat 1: PunterTHFC folded before Flop (didn't bet)
Seat 2: vikim08 showed [Ac 9s] and lost with three of a kind, Kings
Seat 3: heuler27 showed [Qs Qh] and won (28348) with a full house, Kings full of Queens
Seat 5: Exit Shikari folded before Flop (didn't bet)
Seat 6: peterw80 folded before Flop (didn't bet)
Seat 7: willem.lodt (button) folded before Flop (didn't bet)
Seat 8: malik_msk (small blind) folded before Flop
Seat 9: AL3X=PRO (big blind) folded before Flop



PokerStars Game #69717461234: Tournament #544010396, $20+$2 USD Hold'em No Limit - Level XXIII (1000/2000) - 2011/10/30 0:17:07 MSK [2011/10/29 16:17:07 ET]
Table '544010396 89' 9-max Seat #8 is the button
Seat 1: PunterTHFC (21418 in chips) 
Seat 3: heuler27 (76794 in chips) 
Seat 4: adrian_114iz (23450 in chips) 
Seat 5: Exit Shikari (82194 in chips) 
Seat 6: peterw80 (21914 in chips) 
Seat 7: willem.lodt (61678 in chips) 
Seat 8: malik_msk (84425 in chips) 
Seat 9: AL3X=PRO (39524 in chips) 
PunterTHFC: posts the ante 250
heuler27: posts the ante 250
adrian_114iz: posts the ante 250
Exit Shikari: posts the ante 250
peterw80: posts the ante 250
willem.lodt: posts the ante 250
malik_msk: posts the ante 250
AL3X=PRO: posts the ante 250
AL3X=PRO: posts small blind 1000
PunterTHFC: posts big blind 2000
*** HOLE CARDS ***
Dealt to malik_msk [3c 3h]
heuler27: folds 
adrian_114iz: folds 
Exit Shikari: folds 
peterw80: raises 2000 to 4000
willem.lodt: raises 6000 to 10000
malik_msk: folds 
AL3X=PRO: folds 
PunterTHFC: folds 
peterw80: folds 
Uncalled bet (6000) returned to willem.lodt
willem.lodt collected 13000 from pot
willem.lodt: doesn't show hand 
*** SUMMARY ***
Total pot 13000 | Rake 0 
Seat 1: PunterTHFC (big blind) folded before Flop
Seat 3: heuler27 folded before Flop (didn't bet)
Seat 4: adrian_114iz folded before Flop (didn't bet)
Seat 5: Exit Shikari folded before Flop (didn't bet)
Seat 6: peterw80 folded before Flop
Seat 7: willem.lodt collected (13000)
Seat 8: malik_msk (button) folded before Flop (didn't bet)
Seat 9: AL3X=PRO (small blind) folded before Flop



PokerStars Game #69717552340: Tournament #544010396, $20+$2 USD Hold'em No Limit - Level XXIII (1000/2000) - 2011/10/30 0:18:47 MSK [2011/10/29 16:18:47 ET]
Table '544010396 89' 9-max Seat #9 is the button
Seat 1: PunterTHFC (19168 in chips) 
Seat 3: heuler27 (76544 in chips) 
Seat 4: adrian_114iz (23200 in chips) 
Seat 5: Exit Shikari (81944 in chips) 
Seat 6: peterw80 (17664 in chips) 
Seat 7: willem.lodt (70428 in chips) 
Seat 8: malik_msk (84175 in chips) 
Seat 9: AL3X=PRO (38274 in chips) 
PunterTHFC: posts the ante 250
heuler27: posts the ante 250
adrian_114iz: posts the ante 250
Exit Shikari: posts the ante 250
peterw80: posts the ante 250
willem.lodt: posts the ante 250
malik_msk: posts the ante 250
AL3X=PRO: posts the ante 250
PunterTHFC: posts small blind 1000
heuler27: posts big blind 2000
*** HOLE CARDS ***
Dealt to malik_msk [8d 8h]
adrian_114iz: folds 
Exit Shikari: raises 3000 to 5000
kreutz333 is connected 
peterw80: folds 
willem.lodt: folds 
malik_msk: raises 7000 to 12000
AL3X=PRO: folds 
PunterTHFC: folds 
heuler27: folds 
Exit Shikari: calls 7000
*** FLOP *** [3h 7c 7d]
Exit Shikari: bets 12000
malik_msk: raises 59925 to 71925 and is all-in
Exit Shikari: folds 
Uncalled bet (59925) returned to malik_msk
malik_msk collected 53000 from pot
malik_msk: doesn't show hand 
*** SUMMARY ***
Total pot 53000 | Rake 0 
Board [3h 7c 7d]
Seat 1: PunterTHFC (small blind) folded before Flop
Seat 3: heuler27 (big blind) folded before Flop
Seat 4: adrian_114iz folded before Flop (didn't bet)
Seat 5: Exit Shikari folded on the Flop
Seat 6: peterw80 folded before Flop (didn't bet)
Seat 7: willem.lodt folded before Flop (didn't bet)
Seat 8: malik_msk collected (53000)
Seat 9: AL3X=PRO (button) folded before Flop (didn't bet)



PokerStars Game #69717639632: Tournament #544010396, $20+$2 USD Hold'em No Limit - Level XXIV (1200/2400) - 2011/10/30 0:20:25 MSK [2011/10/29 16:20:25 ET]
Table '544010396 89' 9-max Seat #1 is the button
Seat 1: PunterTHFC (17918 in chips) 
Seat 2: kreutz333 (24288 in chips) out of hand (moved from another table into small blind)
Seat 3: heuler27 (74294 in chips) 
Seat 4: adrian_114iz (22950 in chips) 
Seat 5: Exit Shikari (57694 in chips) 
Seat 6: peterw80 (17414 in chips) 
Seat 7: willem.lodt (70178 in chips) 
Seat 8: malik_msk (112925 in chips) 
Seat 9: AL3X=PRO (38024 in chips) 
PunterTHFC: posts the ante 300
heuler27: posts the ante 300
adrian_114iz: posts the ante 300
Exit Shikari: posts the ante 300
peterw80: posts the ante 300
willem.lodt: posts the ante 300
malik_msk: posts the ante 300
AL3X=PRO: posts the ante 300
heuler27: posts small blind 1200
adrian_114iz: posts big blind 2400
*** HOLE CARDS ***
Dealt to malik_msk [7d 4d]
Exit Shikari: folds 
peterw80: folds 
willem.lodt: calls 2400
malik_msk: folds 
AL3X=PRO: folds 
PunterTHFC: folds 
heuler27: calls 1200
adrian_114iz: checks 
*** FLOP *** [8d Ah 3h]
heuler27: checks 
adrian_114iz: checks 
willem.lodt: bets 2400
heuler27: folds 
adrian_114iz: folds 
Uncalled bet (2400) returned to willem.lodt
willem.lodt collected 9600 from pot
willem.lodt: doesn't show hand 
*** SUMMARY ***
Total pot 9600 | Rake 0 
Board [8d Ah 3h]
Seat 1: PunterTHFC (button) folded before Flop (didn't bet)
Seat 3: heuler27 (small blind) folded on the Flop
Seat 4: adrian_114iz (big blind) folded on the Flop
Seat 5: Exit Shikari folded before Flop (didn't bet)
Seat 6: peterw80 folded before Flop (didn't bet)
Seat 7: willem.lodt collected (9600)
Seat 8: malik_msk folded before Flop (didn't bet)
Seat 9: AL3X=PRO folded before Flop (didn't bet)



PokerStars Game #69717711717: Tournament #544010396, $20+$2 USD Hold'em No Limit - Level XXIV (1200/2400) - 2011/10/30 0:21:45 MSK [2011/10/29 16:21:45 ET]
Table '544010396 89' 9-max Seat #3 is the button
Seat 1: PunterTHFC (17618 in chips) 
Seat 2: kreutz333 (24288 in chips) 
Seat 3: heuler27 (71594 in chips) 
Seat 4: adrian_114iz (20250 in chips) 
Seat 5: Exit Shikari (57394 in chips) 
Seat 6: peterw80 (17114 in chips) 
Seat 7: willem.lodt (77078 in chips) 
Seat 8: malik_msk (112625 in chips) 
Seat 9: AL3X=PRO (37724 in chips) 
PunterTHFC: posts the ante 300
kreutz333: posts the ante 300
heuler27: posts the ante 300
adrian_114iz: posts the ante 300
Exit Shikari: posts the ante 300
peterw80: posts the ante 300
willem.lodt: posts the ante 300
malik_msk: posts the ante 300
AL3X=PRO: posts the ante 300
adrian_114iz: posts small blind 1200
Exit Shikari: posts big blind 2400
*** HOLE CARDS ***
Dealt to malik_msk [7d Ah]
peterw80: raises 14414 to 16814 and is all-in
willem.lodt: folds 
malik_msk: folds 
AL3X=PRO: folds 
PunterTHFC: folds 
kreutz333: folds 
heuler27: folds 
adrian_114iz: folds 
Exit Shikari: folds 
Uncalled bet (14414) returned to peterw80
peterw80 collected 8700 from pot
*** SUMMARY ***
Total pot 8700 | Rake 0 
Seat 1: PunterTHFC folded before Flop (didn't bet)
Seat 2: kreutz333 folded before Flop (didn't bet)
Seat 3: heuler27 (button) folded before Flop (didn't bet)
Seat 4: adrian_114iz (small blind) folded before Flop
Seat 5: Exit Shikari (big blind) folded before Flop
Seat 6: peterw80 collected (8700)
Seat 7: willem.lodt folded before Flop (didn't bet)
Seat 8: malik_msk folded before Flop (didn't bet)
Seat 9: AL3X=PRO folded before Flop (didn't bet)



PokerStars Game #69717749228: Tournament #544010396, $20+$2 USD Hold'em No Limit - Level XXIV (1200/2400) - 2011/10/30 0:22:27 MSK [2011/10/29 16:22:27 ET]
Table '544010396 89' 9-max Seat #4 is the button
Seat 1: PunterTHFC (17318 in chips) 
Seat 2: kreutz333 (23988 in chips) 
Seat 3: heuler27 (71294 in chips) 
Seat 4: adrian_114iz (18750 in chips) 
Seat 5: Exit Shikari (54694 in chips) 
Seat 6: peterw80 (23114 in chips) 
Seat 7: willem.lodt (76778 in chips) 
Seat 8: malik_msk (112325 in chips) 
Seat 9: AL3X=PRO (37424 in chips) 
PunterTHFC: posts the ante 300
kreutz333: posts the ante 300
heuler27: posts the ante 300
adrian_114iz: posts the ante 300
Exit Shikari: posts the ante 300
peterw80: posts the ante 300
willem.lodt: posts the ante 300
malik_msk: posts the ante 300
AL3X=PRO: posts the ante 300
Exit Shikari: posts small blind 1200
peterw80: posts big blind 2400
*** HOLE CARDS ***
Dealt to malik_msk [Th Kc]
willem.lodt: folds 
malik_msk: calls 2400
AL3X=PRO: folds 
PunterTHFC: folds 
kreutz333: folds 
heuler27: calls 2400
adrian_114iz: folds 
Exit Shikari: calls 1200
peterw80: checks 
*** FLOP *** [5d 4h 8h]
Exit Shikari: checks 
peterw80: checks 
malik_msk: checks 
heuler27: checks 
*** TURN *** [5d 4h 8h] [Kh]
Exit Shikari: checks 
peterw80: checks 
malik_msk: bets 9600
heuler27: folds 
Exit Shikari: folds 
peterw80: folds 
Uncalled bet (9600) returned to malik_msk
malik_msk collected 12300 from pot
malik_msk: doesn't show hand 
*** SUMMARY ***
Total pot 12300 | Rake 0 
Board [5d 4h 8h Kh]
Seat 1: PunterTHFC folded before Flop (didn't bet)
Seat 2: kreutz333 folded before Flop (didn't bet)
Seat 3: heuler27 folded on the Turn
Seat 4: adrian_114iz (button) folded before Flop (didn't bet)
Seat 5: Exit Shikari (small blind) folded on the Turn
Seat 6: peterw80 (big blind) folded on the Turn
Seat 7: willem.lodt folded before Flop (didn't bet)
Seat 8: malik_msk collected (12300)
Seat 9: AL3X=PRO folded before Flop (didn't bet)



PokerStars Game #69717894178: Tournament #544010396, $20+$2 USD Hold'em No Limit - Level XXIV (1200/2400) - 2011/10/30 0:25:10 MSK [2011/10/29 16:25:10 ET]
Table '544010396 89' 9-max Seat #5 is the button
Seat 1: PunterTHFC (17018 in chips) 
Seat 2: kreutz333 (23688 in chips) 
Seat 3: heuler27 (68594 in chips) 
Seat 4: adrian_114iz (18450 in chips) 
Seat 5: Exit Shikari (51994 in chips) 
Seat 6: peterw80 (20414 in chips) 
Seat 7: willem.lodt (76478 in chips) 
Seat 8: malik_msk (121925 in chips) 
Seat 9: AL3X=PRO (37124 in chips) 
PunterTHFC: posts the ante 300
kreutz333: posts the ante 300
heuler27: posts the ante 300
adrian_114iz: posts the ante 300
Exit Shikari: posts the ante 300
peterw80: posts the ante 300
willem.lodt: posts the ante 300
malik_msk: posts the ante 300
AL3X=PRO: posts the ante 300
peterw80: posts small blind 1200
willem.lodt: posts big blind 2400
*** HOLE CARDS ***
Dealt to malik_msk [2h 6s]
malik_msk: folds 
AL3X=PRO: raises 3120 to 5520
PunterTHFC: folds 
kreutz333: folds 
heuler27: folds 
adrian_114iz: folds 
Exit Shikari: folds 
peterw80: folds 
willem.lodt: calls 3120
*** FLOP *** [8s 2d Kd]
willem.lodt: checks 
AL3X=PRO: bets 7470
willem.lodt: calls 7470
*** TURN *** [8s 2d Kd] [3c]
willem.lodt: checks 
AL3X=PRO: bets 23834 and is all-in
willem.lodt: calls 23834
*** RIVER *** [8s 2d Kd 3c] [Ad]
*** SHOW DOWN ***
willem.lodt: shows [9s Ks] (a pair of Kings)
AL3X=PRO: shows [Th Kh] (a pair of Kings - Ace+Ten kicker)
AL3X=PRO collected 77548 from pot
*** SUMMARY ***
Total pot 77548 | Rake 0 
Board [8s 2d Kd 3c Ad]
Seat 1: PunterTHFC folded before Flop (didn't bet)
Seat 2: kreutz333 folded before Flop (didn't bet)
Seat 3: heuler27 folded before Flop (didn't bet)
Seat 4: adrian_114iz folded before Flop (didn't bet)
Seat 5: Exit Shikari (button) folded before Flop (didn't bet)
Seat 6: peterw80 (small blind) folded before Flop
Seat 7: willem.lodt (big blind) showed [9s Ks] and lost with a pair of Kings
Seat 8: malik_msk folded before Flop (didn't bet)
Seat 9: AL3X=PRO showed [Th Kh] and won (77548) with a pair of Kings



PokerStars Game #69717985129: Tournament #544010396, $20+$2 USD Hold'em No Limit - Level XXIV (1200/2400) - 2011/10/30 0:26:54 MSK [2011/10/29 16:26:54 ET]
Table '544010396 89' 9-max Seat #6 is the button
Seat 1: PunterTHFC (16718 in chips) 
Seat 2: kreutz333 (23388 in chips) 
Seat 3: heuler27 (68294 in chips) 
Seat 4: adrian_114iz (18150 in chips) 
Seat 5: Exit Shikari (51694 in chips) 
Seat 6: peterw80 (18914 in chips) 
Seat 7: willem.lodt (39354 in chips) 
Seat 8: malik_msk (121625 in chips) 
Seat 9: AL3X=PRO (77548 in chips) 
PunterTHFC: posts the ante 300
kreutz333: posts the ante 300
heuler27: posts the ante 300
adrian_114iz: posts the ante 300
Exit Shikari: posts the ante 300
peterw80: posts the ante 300
willem.lodt: posts the ante 300
malik_msk: posts the ante 300
AL3X=PRO: posts the ante 300
willem.lodt: posts small blind 1200
malik_msk: posts big blind 2400
*** HOLE CARDS ***
Dealt to malik_msk [Td Jh]
AL3X=PRO: folds 
PunterTHFC: folds 
kreutz333: raises 20688 to 23088 and is all-in
heuler27: calls 23088
adrian_114iz: folds 
Exit Shikari: folds 
peterw80: folds 
willem.lodt: folds 
malik_msk: folds 
*** FLOP *** [Kd 5c 9c]
*** TURN *** [Kd 5c 9c] [3s]
*** RIVER *** [Kd 5c 9c 3s] [Qh]
*** SHOW DOWN ***
kreutz333: shows [8c 8h] (a pair of Eights)
heuler27: shows [Ac Ah] (a pair of Aces)
heuler27 collected 52476 from pot
kreutz333 finished the tournament in 123rd place and received $79.09.
*** SUMMARY ***
Total pot 52476 | Rake 0 
Board [Kd 5c 9c 3s Qh]
Seat 1: PunterTHFC folded before Flop (didn't bet)
Seat 2: kreutz333 showed [8c 8h] and lost with a pair of Eights
Seat 3: heuler27 showed [Ac Ah] and won (52476) with a pair of Aces
Seat 4: adrian_114iz folded before Flop (didn't bet)
Seat 5: Exit Shikari folded before Flop (didn't bet)
Seat 6: peterw80 (button) folded before Flop (didn't bet)
Seat 7: willem.lodt (small blind) folded before Flop
Seat 8: malik_msk (big blind) folded before Flop
Seat 9: AL3X=PRO folded before Flop (didn't bet)



PokerStars Game #69718027466: Tournament #544010396, $20+$2 USD Hold'em No Limit - Level XXIV (1200/2400) - 2011/10/30 0:27:42 MSK [2011/10/29 16:27:42 ET]
Table '544010396 89' 9-max Seat #7 is the button
Seat 1: PunterTHFC (16418 in chips) 
Seat 3: heuler27 (97382 in chips) 
Seat 4: adrian_114iz (17850 in chips) 
Seat 5: Exit Shikari (51394 in chips) 
Seat 6: peterw80 (18614 in chips) 
Seat 7: willem.lodt (37854 in chips) 
Seat 8: malik_msk (118925 in chips) 
Seat 9: AL3X=PRO (77248 in chips) 
PunterTHFC: posts the ante 300
heuler27: posts the ante 300
adrian_114iz: posts the ante 300
Exit Shikari: posts the ante 300
peterw80: posts the ante 300
willem.lodt: posts the ante 300
malik_msk: posts the ante 300
AL3X=PRO: posts the ante 300
malik_msk: posts small blind 1200
AL3X=PRO: posts big blind 2400
*** HOLE CARDS ***
Dealt to malik_msk [6h Tc]
PunterTHFC: folds 
heuler27: folds 
adrian_114iz: folds 
Exit Shikari: raises 4800 to 7200
peterw80: folds 
willem.lodt: folds 
malik_msk: folds 
AL3X=PRO: folds 
Uncalled bet (4800) returned to Exit Shikari
Exit Shikari collected 8400 from pot
Exit Shikari: doesn't show hand 
*** SUMMARY ***
Total pot 8400 | Rake 0 
Seat 1: PunterTHFC folded before Flop (didn't bet)
Seat 3: heuler27 folded before Flop (didn't bet)
Seat 4: adrian_114iz folded before Flop (didn't bet)
Seat 5: Exit Shikari collected (8400)
Seat 6: peterw80 folded before Flop (didn't bet)
Seat 7: willem.lodt (button) folded before Flop (didn't bet)
Seat 8: malik_msk (small blind) folded before Flop
Seat 9: AL3X=PRO (big blind) folded before Flop



PokerStars Game #69718065963: Tournament #544010396, $20+$2 USD Hold'em No Limit - Level XXIV (1200/2400) - 2011/10/30 0:28:26 MSK [2011/10/29 16:28:26 ET]
Table '544010396 89' 9-max Seat #8 is the button
Seat 1: PunterTHFC (16118 in chips) 
Seat 3: heuler27 (97082 in chips) 
Seat 4: adrian_114iz (17550 in chips) 
Seat 5: Exit Shikari (57094 in chips) 
Seat 6: peterw80 (18314 in chips) 
Seat 7: willem.lodt (37554 in chips) 
Seat 8: malik_msk (117425 in chips) 
Seat 9: AL3X=PRO (74548 in chips) 
PunterTHFC: posts the ante 300
heuler27: posts the ante 300
adrian_114iz: posts the ante 300
Exit Shikari: posts the ante 300
peterw80: posts the ante 300
willem.lodt: posts the ante 300
malik_msk: posts the ante 300
AL3X=PRO: posts the ante 300
AL3X=PRO: posts small blind 1200
PunterTHFC: posts big blind 2400
*** HOLE CARDS ***
Dealt to malik_msk [3c 8h]
heuler27: folds 
adrian_114iz: folds 
Exit Shikari: folds 
peterw80: folds 
willem.lodt: raises 4800 to 7200
malik_msk: folds 
AL3X=PRO: folds 
PunterTHFC: raises 8618 to 15818 and is all-in
willem.lodt: calls 8618
*** FLOP *** [Ah Kh Kc]
*** TURN *** [Ah Kh Kc] [9d]
*** RIVER *** [Ah Kh Kc 9d] [7h]
*** SHOW DOWN ***
PunterTHFC: shows [Jd Td] (a pair of Kings)
willem.lodt: shows [6s As] (two pair, Aces and Kings)
willem.lodt collected 35236 from pot
PunterTHFC finished the tournament in 119th place and received $79.09.
*** SUMMARY ***
Total pot 35236 | Rake 0 
Board [Ah Kh Kc 9d 7h]
Seat 1: PunterTHFC (big blind) showed [Jd Td] and lost with a pair of Kings
Seat 3: heuler27 folded before Flop (didn't bet)
Seat 4: adrian_114iz folded before Flop (didn't bet)
Seat 5: Exit Shikari folded before Flop (didn't bet)
Seat 6: peterw80 folded before Flop (didn't bet)
Seat 7: willem.lodt showed [6s As] and won (35236) with two pair, Aces and Kings
Seat 8: malik_msk (button) folded before Flop (didn't bet)
Seat 9: AL3X=PRO (small blind) folded before Flop



PokerStars Game #69718118125: Tournament #544010396, $20+$2 USD Hold'em No Limit - Level XXV (1400/2800) - 2011/10/30 0:29:27 MSK [2011/10/29 16:29:27 ET]
Table '544010396 89' 9-max Seat #9 is the button
Seat 2: MskrevFIX (60412 in chips) out of hand (moved from another table into small blind)
Seat 3: heuler27 (96782 in chips) 
Seat 4: adrian_114iz (17250 in chips) 
Seat 5: Exit Shikari (56794 in chips) 
Seat 6: peterw80 (18014 in chips) 
Seat 7: willem.lodt (56672 in chips) 
Seat 8: malik_msk (117125 in chips) 
Seat 9: AL3X=PRO (73048 in chips) 
heuler27: posts the ante 350
adrian_114iz: posts the ante 350
Exit Shikari: posts the ante 350
peterw80: posts the ante 350
willem.lodt: posts the ante 350
malik_msk: posts the ante 350
AL3X=PRO: posts the ante 350
heuler27: posts small blind 1400
adrian_114iz: posts big blind 2800
*** HOLE CARDS ***
Dealt to malik_msk [8d 9s]
Exit Shikari: folds 
peterw80 has timed out
peterw80: folds 
peterw80 is sitting out
peterw80 has returned
willem.lodt: folds 
malik_msk: calls 2800
AL3X=PRO: folds 
heuler27: calls 1400
adrian_114iz: raises 14000 to 16800
malik_msk: folds 
heuler27: folds 
Uncalled bet (14000) returned to adrian_114iz
adrian_114iz collected 10850 from pot
*** SUMMARY ***
Total pot 10850 | Rake 0 
Seat 3: heuler27 (small blind) folded before Flop
Seat 4: adrian_114iz (big blind) collected (10850)
Seat 5: Exit Shikari folded before Flop (didn't bet)
Seat 6: peterw80 folded before Flop (didn't bet)
Seat 7: willem.lodt folded before Flop (didn't bet)
Seat 8: malik_msk folded before Flop
Seat 9: AL3X=PRO (button) folded before Flop (didn't bet)



PokerStars Game #69718199391: Tournament #544010396, $20+$2 USD Hold'em No Limit - Level XXV (1400/2800) - 2011/10/30 0:30:58 MSK [2011/10/29 16:30:58 ET]
Table '544010396 89' 9-max Seat #3 is the button
Seat 2: MskrevFIX (60412 in chips) 
Seat 3: heuler27 (93632 in chips) 
Seat 4: adrian_114iz (24950 in chips) 
Seat 5: Exit Shikari (56444 in chips) 
Seat 6: peterw80 (17664 in chips) 
Seat 7: willem.lodt (56322 in chips) 
Seat 8: malik_msk (113975 in chips) 
Seat 9: AL3X=PRO (72698 in chips) 
MskrevFIX: posts the ante 350
heuler27: posts the ante 350
adrian_114iz: posts the ante 350
Exit Shikari: posts the ante 350
peterw80: posts the ante 350
willem.lodt: posts the ante 350
malik_msk: posts the ante 350
AL3X=PRO: posts the ante 350
adrian_114iz: posts small blind 1400
Exit Shikari: posts big blind 2800
*** HOLE CARDS ***
Dealt to malik_msk [5h 2h]
peterw80: folds 
willem.lodt: folds 
malik_msk: folds 
AL3X=PRO: raises 3639 to 6439
MskrevFIX: folds 
heuler27 is disconnected 
triple920 is connected 
heuler27 has timed out while disconnected
heuler27: folds 
heuler27 is sitting out
adrian_114iz: folds 
Exit Shikari: folds 
Uncalled bet (3639) returned to AL3X=PRO
AL3X=PRO collected 9800 from pot
*** SUMMARY ***
Total pot 9800 | Rake 0 
Seat 2: MskrevFIX folded before Flop (didn't bet)
Seat 3: heuler27 (button) folded before Flop (didn't bet)
Seat 4: adrian_114iz (small blind) folded before Flop
Seat 5: Exit Shikari (big blind) folded before Flop
Seat 6: peterw80 folded before Flop (didn't bet)
Seat 7: willem.lodt folded before Flop (didn't bet)
Seat 8: malik_msk folded before Flop (didn't bet)
Seat 9: AL3X=PRO collected (9800)



PokerStars Game #69718353248: Tournament #544010396, $20+$2 USD Hold'em No Limit - Level XXV (1400/2800) - 2011/10/30 0:33:44 MSK [2011/10/29 16:33:44 ET]
Table '544010396 89' 9-max Seat #4 is the button
Seat 1: triple920 (178063 in chips) 
Seat 2: MskrevFIX (60062 in chips) 
Seat 3: heuler27 (93282 in chips) is sitting out
Seat 4: adrian_114iz (23200 in chips) 
Seat 5: Exit Shikari (53294 in chips) 
Seat 6: peterw80 (17314 in chips) 
Seat 7: willem.lodt (55972 in chips) 
Seat 8: malik_msk (113625 in chips) 
Seat 9: AL3X=PRO (79348 in chips) 
triple920: posts the ante 350
MskrevFIX: posts the ante 350
heuler27: posts the ante 350
adrian_114iz: posts the ante 350
Exit Shikari: posts the ante 350
peterw80: posts the ante 350
willem.lodt: posts the ante 350
malik_msk: posts the ante 350
AL3X=PRO: posts the ante 350
Exit Shikari: posts small blind 1400
peterw80: posts big blind 2800
*** HOLE CARDS ***
Dealt to malik_msk [Ks 3s]
willem.lodt: raises 2800 to 5600
malik_msk: folds 
AL3X=PRO: folds 
triple920: folds 
MskrevFIX: folds 
heuler27: folds 
adrian_114iz: folds 
Exit Shikari: folds 
peterw80: folds 
Uncalled bet (2800) returned to willem.lodt
willem.lodt collected 10150 from pot
willem.lodt: doesn't show hand 
*** SUMMARY ***
Total pot 10150 | Rake 0 
Seat 1: triple920 folded before Flop (didn't bet)
Seat 2: MskrevFIX folded before Flop (didn't bet)
Seat 3: heuler27 folded before Flop (didn't bet)
Seat 4: adrian_114iz (button) folded before Flop (didn't bet)
Seat 5: Exit Shikari (small blind) folded before Flop
Seat 6: peterw80 (big blind) folded before Flop
Seat 7: willem.lodt collected (10150)
Seat 8: malik_msk folded before Flop (didn't bet)
Seat 9: AL3X=PRO folded before Flop (didn't bet)



PokerStars Game #69718391181: Tournament #544010396, $20+$2 USD Hold'em No Limit - Level XXV (1400/2800) - 2011/10/30 0:34:26 MSK [2011/10/29 16:34:26 ET]
Table '544010396 89' 9-max Seat #5 is the button
Seat 1: triple920 (177713 in chips) 
Seat 2: MskrevFIX (59712 in chips) 
Seat 3: heuler27 (92932 in chips) is sitting out
Seat 4: adrian_114iz (22850 in chips) 
Seat 5: Exit Shikari (51544 in chips) 
Seat 6: peterw80 (14164 in chips) 
Seat 7: willem.lodt (62972 in chips) 
Seat 8: malik_msk (113275 in chips) 
Seat 9: AL3X=PRO (78998 in chips) 
triple920: posts the ante 350
MskrevFIX: posts the ante 350
heuler27: posts the ante 350
adrian_114iz: posts the ante 350
Exit Shikari: posts the ante 350
peterw80: posts the ante 350
willem.lodt: posts the ante 350
malik_msk: posts the ante 350
AL3X=PRO: posts the ante 350
peterw80: posts small blind 1400
willem.lodt: posts big blind 2800
*** HOLE CARDS ***
Dealt to malik_msk [Td 7c]
malik_msk: folds 
AL3X=PRO: folds 
triple920: raises 2800 to 5600
MskrevFIX: folds 
heuler27: folds 
adrian_114iz: raises 16800 to 22400
Exit Shikari: folds 
peterw80: folds 
willem.lodt: folds 
triple920: calls 16800
*** FLOP *** [4h 9d Ac]
triple920: bets 2800
adrian_114iz: calls 100 and is all-in
Uncalled bet (2700) returned to triple920
*** TURN *** [4h 9d Ac] [6c]
*** RIVER *** [4h 9d Ac 6c] [2d]
*** SHOW DOWN ***
triple920: shows [Kh Qs] (high card Ace)
adrian_114iz: shows [Kc Jc] (high card Ace - lower kicker)
triple920 collected 52350 from pot
adrian_114iz finished the tournament in 110th place and received $85.17.
*** SUMMARY ***
Total pot 52350 | Rake 0 
Board [4h 9d Ac 6c 2d]
Seat 1: triple920 showed [Kh Qs] and won (52350) with high card Ace
Seat 2: MskrevFIX folded before Flop (didn't bet)
Seat 3: heuler27 folded before Flop (didn't bet)
Seat 4: adrian_114iz showed [Kc Jc] and lost with high card Ace
Seat 5: Exit Shikari (button) folded before Flop (didn't bet)
Seat 6: peterw80 (small blind) folded before Flop
Seat 7: willem.lodt (big blind) folded before Flop
Seat 8: malik_msk folded before Flop (didn't bet)
Seat 9: AL3X=PRO folded before Flop (didn't bet)



PokerStars Game #69718447417: Tournament #544010396, $20+$2 USD Hold'em No Limit - Level XXV (1400/2800) - 2011/10/30 0:35:27 MSK [2011/10/29 16:35:27 ET]
Table '544010396 89' 9-max Seat #6 is the button
Seat 1: triple920 (207213 in chips) 
Seat 2: MskrevFIX (59362 in chips) 
Seat 3: heuler27 (92582 in chips) is sitting out
Seat 5: Exit Shikari (51194 in chips) 
Seat 6: peterw80 (12414 in chips) 
Seat 7: willem.lodt (59822 in chips) 
Seat 8: malik_msk (112925 in chips) 
Seat 9: AL3X=PRO (78648 in chips) 
triple920: posts the ante 350
MskrevFIX: posts the ante 350
heuler27: posts the ante 350
Exit Shikari: posts the ante 350
peterw80: posts the ante 350
willem.lodt: posts the ante 350
malik_msk: posts the ante 350
AL3X=PRO: posts the ante 350
willem.lodt: posts small blind 1400
malik_msk: posts big blind 2800
*** HOLE CARDS ***
Dealt to malik_msk [8s 2h]
AL3X=PRO: folds 
triple920: folds 
MskrevFIX: folds 
heuler27: folds 
Exit Shikari: raises 48044 to 50844 and is all-in
heuler27 is connected 
heuler27 has returned
peterw80: folds 
devils_range is connected 
willem.lodt: folds 
malik_msk: folds 
Uncalled bet (48044) returned to Exit Shikari
Exit Shikari collected 9800 from pot
*** SUMMARY ***
Total pot 9800 | Rake 0 
Seat 1: triple920 folded before Flop (didn't bet)
Seat 2: MskrevFIX folded before Flop (didn't bet)
Seat 3: heuler27 folded before Flop (didn't bet)
Seat 5: Exit Shikari collected (9800)
Seat 6: peterw80 (button) folded before Flop (didn't bet)
Seat 7: willem.lodt (small blind) folded before Flop
Seat 8: malik_msk (big blind) folded before Flop
Seat 9: AL3X=PRO folded before Flop (didn't bet)



PokerStars Game #69718489803: Tournament #544010396, $20+$2 USD Hold'em No Limit - Level XXV (1400/2800) - 2011/10/30 0:36:14 MSK [2011/10/29 16:36:14 ET]
Table '544010396 89' 9-max Seat #7 is the button
Seat 1: triple920 (206863 in chips) 
Seat 2: MskrevFIX (59012 in chips) 
Seat 3: heuler27 (92232 in chips) 
Seat 4: devils_range (52366 in chips) 
Seat 5: Exit Shikari (57844 in chips) 
Seat 6: peterw80 (12064 in chips) 
Seat 7: willem.lodt (58072 in chips) 
Seat 8: malik_msk (109775 in chips) 
Seat 9: AL3X=PRO (78298 in chips) 
triple920: posts the ante 350
MskrevFIX: posts the ante 350
heuler27: posts the ante 350
devils_range: posts the ante 350
Exit Shikari: posts the ante 350
peterw80: posts the ante 350
willem.lodt: posts the ante 350
malik_msk: posts the ante 350
AL3X=PRO: posts the ante 350
malik_msk: posts small blind 1400
AL3X=PRO: posts big blind 2800
*** HOLE CARDS ***
Dealt to malik_msk [Kd 2d]
triple920: folds 
MskrevFIX: raises 2990 to 5790
heuler27: folds 
devils_range: folds 
Exit Shikari: folds 
peterw80: folds 
willem.lodt: folds 
malik_msk: folds 
AL3X=PRO: folds 
Uncalled bet (2990) returned to MskrevFIX
MskrevFIX collected 10150 from pot
MskrevFIX: doesn't show hand 
*** SUMMARY ***
Total pot 10150 | Rake 0 
Seat 1: triple920 folded before Flop (didn't bet)
Seat 2: MskrevFIX collected (10150)
Seat 3: heuler27 folded before Flop (didn't bet)
Seat 4: devils_range folded before Flop (didn't bet)
Seat 5: Exit Shikari folded before Flop (didn't bet)
Seat 6: peterw80 folded before Flop (didn't bet)
Seat 7: willem.lodt (button) folded before Flop (didn't bet)
Seat 8: malik_msk (small blind) folded before Flop
Seat 9: AL3X=PRO (big blind) folded before Flop



PokerStars Game #69718551857: Tournament #544010396, $20+$2 USD Hold'em No Limit - Level XXV (1400/2800) - 2011/10/30 0:37:23 MSK [2011/10/29 16:37:23 ET]
Table '544010396 89' 9-max Seat #8 is the button
Seat 1: triple920 (206513 in chips) 
Seat 2: MskrevFIX (66012 in chips) 
Seat 3: heuler27 (91882 in chips) 
Seat 4: devils_range (52016 in chips) 
Seat 5: Exit Shikari (57494 in chips) 
Seat 6: peterw80 (11714 in chips) 
Seat 7: willem.lodt (57722 in chips) 
Seat 8: malik_msk (108025 in chips) 
Seat 9: AL3X=PRO (75148 in chips) 
triple920: posts the ante 350
MskrevFIX: posts the ante 350
heuler27: posts the ante 350
devils_range: posts the ante 350
Exit Shikari: posts the ante 350
peterw80: posts the ante 350
willem.lodt: posts the ante 350
malik_msk: posts the ante 350
AL3X=PRO: posts the ante 350
AL3X=PRO: posts small blind 1400
triple920: posts big blind 2800
*** HOLE CARDS ***
Dealt to malik_msk [Kd 3s]
MskrevFIX: folds 
heuler27: folds 
devils_range: folds 
Exit Shikari: folds 
peterw80: folds 
willem.lodt: folds 
malik_msk: folds 
AL3X=PRO: folds 
Uncalled bet (1400) returned to triple920
triple920 collected 5950 from pot
*** SUMMARY ***
Total pot 5950 | Rake 0 
Seat 1: triple920 (big blind) collected (5950)
Seat 2: MskrevFIX folded before Flop (didn't bet)
Seat 3: heuler27 folded before Flop (didn't bet)
Seat 4: devils_range folded before Flop (didn't bet)
Seat 5: Exit Shikari folded before Flop (didn't bet)
Seat 6: peterw80 folded before Flop (didn't bet)
Seat 7: willem.lodt folded before Flop (didn't bet)
Seat 8: malik_msk (button) folded before Flop (didn't bet)
Seat 9: AL3X=PRO (small blind) folded before Flop



PokerStars Game #69718586569: Tournament #544010396, $20+$2 USD Hold'em No Limit - Level XXV (1400/2800) - 2011/10/30 0:38:01 MSK [2011/10/29 16:38:01 ET]
Table '544010396 89' 9-max Seat #9 is the button
Seat 1: triple920 (210713 in chips) 
Seat 2: MskrevFIX (65662 in chips) 
Seat 3: heuler27 (91532 in chips) 
Seat 4: devils_range (51666 in chips) 
Seat 5: Exit Shikari (57144 in chips) 
Seat 6: peterw80 (11364 in chips) 
Seat 7: willem.lodt (57372 in chips) 
Seat 8: malik_msk (107675 in chips) 
Seat 9: AL3X=PRO (73398 in chips) 
triple920: posts the ante 350
MskrevFIX: posts the ante 350
heuler27: posts the ante 350
devils_range: posts the ante 350
Exit Shikari: posts the ante 350
peterw80: posts the ante 350
willem.lodt: posts the ante 350
malik_msk: posts the ante 350
AL3X=PRO: posts the ante 350
triple920: posts small blind 1400
MskrevFIX: posts big blind 2800
*** HOLE CARDS ***
Dealt to malik_msk [Ac 8s]
heuler27: folds 
devils_range: folds 
Exit Shikari: raises 8400 to 11200
peterw80: folds 
willem.lodt: folds 
malik_msk: folds 
AL3X=PRO: folds 
triple920: calls 9800
MskrevFIX: folds 
*** FLOP *** [6s 4d 3c]
triple920: checks 
Exit Shikari: bets 45594 and is all-in
triple920: calls 45594
*** TURN *** [6s 4d 3c] [Th]
*** RIVER *** [6s 4d 3c Th] [5s]
*** SHOW DOWN ***
triple920: shows [9d 9h] (a pair of Nines)
Exit Shikari: shows [Kh Qd] (high card King)
triple920 collected 119538 from pot
Exit Shikari finished the tournament in 103rd place and received $85.17.
*** SUMMARY ***
Total pot 119538 | Rake 0 
Board [6s 4d 3c Th 5s]
Seat 1: triple920 (small blind) showed [9d 9h] and won (119538) with a pair of Nines
Seat 2: MskrevFIX (big blind) folded before Flop
Seat 3: heuler27 folded before Flop (didn't bet)
Seat 4: devils_range folded before Flop (didn't bet)
Seat 5: Exit Shikari showed [Kh Qd] and lost with high card King
Seat 6: peterw80 folded before Flop (didn't bet)
Seat 7: willem.lodt folded before Flop (didn't bet)
Seat 8: malik_msk folded before Flop (didn't bet)
Seat 9: AL3X=PRO (button) folded before Flop (didn't bet)



PokerStars Game #69718658796: Tournament #544010396, $20+$2 USD Hold'em No Limit - Level XXVI (1600/3200) - 2011/10/30 0:39:22 MSK [2011/10/29 16:39:22 ET]
Table '544010396 89' 9-max Seat #1 is the button
Seat 1: triple920 (273107 in chips) 
Seat 2: MskrevFIX (62512 in chips) 
Seat 3: heuler27 (91182 in chips) 
Seat 4: devils_range (51316 in chips) 
Seat 6: peterw80 (11014 in chips) 
Seat 7: willem.lodt (57022 in chips) 
Seat 8: malik_msk (107325 in chips) 
Seat 9: AL3X=PRO (73048 in chips) 
triple920: posts the ante 400
MskrevFIX: posts the ante 400
heuler27: posts the ante 400
devils_range: posts the ante 400
peterw80: posts the ante 400
willem.lodt: posts the ante 400
malik_msk: posts the ante 400
AL3X=PRO: posts the ante 400
MskrevFIX: posts small blind 1600
heuler27: posts big blind 3200
*** HOLE CARDS ***
Dealt to malik_msk [5c 6d]
devils_range: folds 
peterw80: raises 7414 to 10614 and is all-in
willem.lodt: folds 
malik_msk: folds 
AL3X=PRO: folds 
triple920: folds 
MskrevFIX: folds 
heuler27: folds 
Uncalled bet (7414) returned to peterw80
peterw80 collected 11200 from pot
*** SUMMARY ***
Total pot 11200 | Rake 0 
Seat 1: triple920 (button) folded before Flop (didn't bet)
Seat 2: MskrevFIX (small blind) folded before Flop
Seat 3: heuler27 (big blind) folded before Flop
Seat 4: devils_range folded before Flop (didn't bet)
Seat 6: peterw80 collected (11200)
Seat 7: willem.lodt folded before Flop (didn't bet)
Seat 8: malik_msk folded before Flop (didn't bet)
Seat 9: AL3X=PRO folded before Flop (didn't bet)



PokerStars Game #69718686438: Tournament #544010396, $20+$2 USD Hold'em No Limit - Level XXVI (1600/3200) - 2011/10/30 0:39:53 MSK [2011/10/29 16:39:53 ET]
Table '544010396 89' 9-max Seat #2 is the button
Seat 1: triple920 (272707 in chips) 
Seat 2: MskrevFIX (60512 in chips) 
Seat 3: heuler27 (87582 in chips) 
Seat 4: devils_range (50916 in chips) 
Seat 6: peterw80 (18614 in chips) 
Seat 7: willem.lodt (56622 in chips) 
Seat 8: malik_msk (106925 in chips) 
Seat 9: AL3X=PRO (72648 in chips) 
triple920: posts the ante 400
MskrevFIX: posts the ante 400
heuler27: posts the ante 400
devils_range: posts the ante 400
peterw80: posts the ante 400
willem.lodt: posts the ante 400
malik_msk: posts the ante 400
AL3X=PRO: posts the ante 400
heuler27: posts small blind 1600
devils_range: posts big blind 3200
*** HOLE CARDS ***
Dealt to malik_msk [Kh 4h]
peterw80: folds 
willem.lodt: folds 
malik_msk: calls 3200
AL3X=PRO: folds 
triple920: folds 
MskrevFIX: folds 
heuler27: calls 1600
devils_range: checks 
*** FLOP *** [4s 2d 6c]
heuler27: checks 
devils_range: checks 
malik_msk: bets 3200
heuler27: folds 
devils_range: folds 
Uncalled bet (3200) returned to malik_msk
malik_msk collected 12800 from pot
malik_msk: doesn't show hand 
*** SUMMARY ***
Total pot 12800 | Rake 0 
Board [4s 2d 6c]
Seat 1: triple920 folded before Flop (didn't bet)
Seat 2: MskrevFIX (button) folded before Flop (didn't bet)
Seat 3: heuler27 (small blind) folded on the Flop
Seat 4: devils_range (big blind) folded on the Flop
Seat 6: peterw80 folded before Flop (didn't bet)
Seat 7: willem.lodt folded before Flop (didn't bet)
Seat 8: malik_msk collected (12800)
Seat 9: AL3X=PRO folded before Flop (didn't bet)



PokerStars Game #69718742642: Tournament #544010396, $20+$2 USD Hold'em No Limit - Level XXVI (1600/3200) - 2011/10/30 0:40:56 MSK [2011/10/29 16:40:56 ET]
Table '544010396 89' 9-max Seat #3 is the button
Seat 1: triple920 (272307 in chips) 
Seat 2: MskrevFIX (60112 in chips) 
Seat 3: heuler27 (83982 in chips) 
Seat 4: devils_range (47316 in chips) 
Seat 6: peterw80 (18214 in chips) 
Seat 7: willem.lodt (56222 in chips) 
Seat 8: malik_msk (116125 in chips) 
Seat 9: AL3X=PRO (72248 in chips) 
triple920: posts the ante 400
MskrevFIX: posts the ante 400
heuler27: posts the ante 400
devils_range: posts the ante 400
peterw80: posts the ante 400
willem.lodt: posts the ante 400
malik_msk: posts the ante 400
AL3X=PRO: posts the ante 400
devils_range: posts small blind 1600
peterw80: posts big blind 3200
*** HOLE CARDS ***
Dealt to malik_msk [6c Kh]
willem.lodt: folds 
malik_msk: folds 
Takezo1980 is connected 
AL3X=PRO: raises 4159 to 7359
triple920: folds 
MskrevFIX: folds 
heuler27: folds 
devils_range: folds 
peterw80: folds 
Uncalled bet (4159) returned to AL3X=PRO
AL3X=PRO collected 11200 from pot
*** SUMMARY ***
Total pot 11200 | Rake 0 
Seat 1: triple920 folded before Flop (didn't bet)
Seat 2: MskrevFIX folded before Flop (didn't bet)
Seat 3: heuler27 (button) folded before Flop (didn't bet)
Seat 4: devils_range (small blind) folded before Flop
Seat 6: peterw80 (big blind) folded before Flop
Seat 7: willem.lodt folded before Flop (didn't bet)
Seat 8: malik_msk folded before Flop (didn't bet)
Seat 9: AL3X=PRO collected (11200)



PokerStars Game #69718808730: Tournament #544010396, $20+$2 USD Hold'em No Limit - Level XXVI (1600/3200) - 2011/10/30 0:42:10 MSK [2011/10/29 16:42:10 ET]
Table '544010396 89' 9-max Seat #4 is the button
Seat 1: triple920 (271907 in chips) 
Seat 2: MskrevFIX (59712 in chips) 
Seat 3: heuler27 (83582 in chips) 
Seat 4: devils_range (45316 in chips) 
Seat 5: Takezo1980 (112676 in chips) out of hand (moved from another table into small blind)
Seat 6: peterw80 (14614 in chips) 
Seat 7: willem.lodt (55822 in chips) 
Seat 8: malik_msk (115725 in chips) 
Seat 9: AL3X=PRO (79848 in chips) 
triple920: posts the ante 400
MskrevFIX: posts the ante 400
heuler27: posts the ante 400
devils_range: posts the ante 400
peterw80: posts the ante 400
willem.lodt: posts the ante 400
malik_msk: posts the ante 400
AL3X=PRO: posts the ante 400
peterw80: posts small blind 1600
willem.lodt: posts big blind 3200
*** HOLE CARDS ***
Dealt to malik_msk [5s 2d]
malik_msk: folds 
AL3X=PRO: folds 
triple920: folds 
MskrevFIX: folds 
heuler27: folds 
devils_range: raises 4000 to 7200
peterw80: folds 
willem.lodt: calls 4000
*** FLOP *** [Kd 6c Qd]
willem.lodt: checks 
devils_range: bets 9600
willem.lodt: calls 9600
*** TURN *** [Kd 6c Qd] [3s]
willem.lodt: checks 
devils_range: bets 28116 and is all-in
willem.lodt: folds 
Uncalled bet (28116) returned to devils_range
devils_range collected 38400 from pot
devils_range: doesn't show hand 
*** SUMMARY ***
Total pot 38400 | Rake 0 
Board [Kd 6c Qd 3s]
Seat 1: triple920 folded before Flop (didn't bet)
Seat 2: MskrevFIX folded before Flop (didn't bet)
Seat 3: heuler27 folded before Flop (didn't bet)
Seat 4: devils_range (button) collected (38400)
Seat 6: peterw80 (small blind) folded before Flop
Seat 7: willem.lodt (big blind) folded on the Turn
Seat 8: malik_msk folded before Flop (didn't bet)
Seat 9: AL3X=PRO folded before Flop (didn't bet)



PokerStars Game #69718897039: Tournament #544010396, $20+$2 USD Hold'em No Limit - Level XXVI (1600/3200) - 2011/10/30 0:43:50 MSK [2011/10/29 16:43:50 ET]
Table '544010396 89' 9-max Seat #6 is the button
Seat 1: triple920 (271507 in chips) 
Seat 2: MskrevFIX (59312 in chips) 
Seat 3: heuler27 (83182 in chips) 
Seat 4: devils_range (66516 in chips) 
Seat 5: Takezo1980 (112676 in chips) 
Seat 6: peterw80 (12614 in chips) 
Seat 7: willem.lodt (38622 in chips) 
Seat 8: malik_msk (115325 in chips) 
Seat 9: AL3X=PRO (79448 in chips) 
triple920: posts the ante 400
MskrevFIX: posts the ante 400
heuler27: posts the ante 400
devils_range: posts the ante 400
Takezo1980: posts the ante 400
peterw80: posts the ante 400
willem.lodt: posts the ante 400
malik_msk: posts the ante 400
AL3X=PRO: posts the ante 400
willem.lodt: posts small blind 1600
malik_msk: posts big blind 3200
*** HOLE CARDS ***
Dealt to malik_msk [3d 7s]
AL3X=PRO: folds 
triple920: folds 
MskrevFIX: folds 
heuler27: folds 
devils_range: raises 4000 to 7200
Takezo1980: folds 
peterw80: folds 
willem.lodt: calls 5600
malik_msk: folds 
*** FLOP *** [5d 8h 8s]
willem.lodt: checks 
devils_range: checks 
*** TURN *** [5d 8h 8s] [Jc]
willem.lodt: checks 
devils_range: checks 
*** RIVER *** [5d 8h 8s Jc] [2h]
willem.lodt: bets 31022 and is all-in
devils_range: folds 
Uncalled bet (31022) returned to willem.lodt
willem.lodt collected 21200 from pot
willem.lodt: doesn't show hand 
*** SUMMARY ***
Total pot 21200 | Rake 0 
Board [5d 8h 8s Jc 2h]
Seat 1: triple920 folded before Flop (didn't bet)
Seat 2: MskrevFIX folded before Flop (didn't bet)
Seat 3: heuler27 folded before Flop (didn't bet)
Seat 4: devils_range folded on the River
Seat 5: Takezo1980 folded before Flop (didn't bet)
Seat 6: peterw80 (button) folded before Flop (didn't bet)
Seat 7: willem.lodt (small blind) collected (21200)
Seat 8: malik_msk (big blind) folded before Flop
Seat 9: AL3X=PRO folded before Flop (didn't bet)



PokerStars Game #69718964446: Tournament #544010396, $20+$2 USD Hold'em No Limit - Level XXVI (1600/3200) - 2011/10/30 0:45:07 MSK [2011/10/29 16:45:07 ET]
Table '544010396 89' 9-max Seat #7 is the button
Seat 1: triple920 (271107 in chips) 
Seat 2: MskrevFIX (58912 in chips) 
Seat 3: heuler27 (82782 in chips) 
Seat 4: devils_range (58916 in chips) 
Seat 5: Takezo1980 (112276 in chips) 
Seat 6: peterw80 (12214 in chips) 
Seat 7: willem.lodt (52222 in chips) 
Seat 8: malik_msk (111725 in chips) 
Seat 9: AL3X=PRO (79048 in chips) 
triple920: posts the ante 400
MskrevFIX: posts the ante 400
heuler27: posts the ante 400
devils_range: posts the ante 400
Takezo1980: posts the ante 400
peterw80: posts the ante 400
willem.lodt: posts the ante 400
malik_msk: posts the ante 400
AL3X=PRO: posts the ante 400
malik_msk: posts small blind 1600
AL3X=PRO: posts big blind 3200
*** HOLE CARDS ***
Dealt to malik_msk [Qh 8h]
triple920: folds 
MskrevFIX: raises 3370 to 6570
heuler27: folds 
devils_range: folds 
Takezo1980: raises 8005 to 14575
peterw80: folds 
willem.lodt: folds 
malik_msk: folds 
AL3X=PRO: folds 
MskrevFIX: calls 8005
*** FLOP *** [Ts 4s 5d]
MskrevFIX: checks 
Takezo1980: bets 18775
MskrevFIX: folds 
Uncalled bet (18775) returned to Takezo1980
Takezo1980 collected 37550 from pot
*** SUMMARY ***
Total pot 37550 | Rake 0 
Board [Ts 4s 5d]
Seat 1: triple920 folded before Flop (didn't bet)
Seat 2: MskrevFIX folded on the Flop
Seat 3: heuler27 folded before Flop (didn't bet)
Seat 4: devils_range folded before Flop (didn't bet)
Seat 5: Takezo1980 collected (37550)
Seat 6: peterw80 folded before Flop (didn't bet)
Seat 7: willem.lodt (button) folded before Flop (didn't bet)
Seat 8: malik_msk (small blind) folded before Flop
Seat 9: AL3X=PRO (big blind) folded before Flop



PokerStars Game #69719040713: Tournament #544010396, $20+$2 USD Hold'em No Limit - Level XXVI (1600/3200) - 2011/10/30 0:46:35 MSK [2011/10/29 16:46:35 ET]
Table '544010396 89' 9-max Seat #8 is the button
Seat 1: triple920 (270707 in chips) 
Seat 2: MskrevFIX (43937 in chips) 
Seat 3: heuler27 (82382 in chips) 
Seat 4: devils_range (58516 in chips) 
Seat 5: Takezo1980 (134851 in chips) 
Seat 6: peterw80 (11814 in chips) 
Seat 7: willem.lodt (51822 in chips) 
Seat 8: malik_msk (109725 in chips) 
Seat 9: AL3X=PRO (75448 in chips) 
triple920: posts the ante 400
MskrevFIX: posts the ante 400
heuler27: posts the ante 400
devils_range: posts the ante 400
Takezo1980: posts the ante 400
peterw80: posts the ante 400
willem.lodt: posts the ante 400
malik_msk: posts the ante 400
AL3X=PRO: posts the ante 400
AL3X=PRO: posts small blind 1600
triple920: posts big blind 3200
*** HOLE CARDS ***
Dealt to malik_msk [2d Ah]
MskrevFIX: folds 
heuler27: raises 6400 to 9600
devils_range: folds 
Takezo1980: folds 
peterw80 has timed out
peterw80: folds 
peterw80 is sitting out
willem.lodt: folds 
peterw80 has returned
malik_msk: folds 
AL3X=PRO: folds 
triple920: folds 
Uncalled bet (6400) returned to heuler27
heuler27 collected 11600 from pot
heuler27: doesn't show hand 
*** SUMMARY ***
Total pot 11600 | Rake 0 
Seat 1: triple920 (big blind) folded before Flop
Seat 2: MskrevFIX folded before Flop (didn't bet)
Seat 3: heuler27 collected (11600)
Seat 4: devils_range folded before Flop (didn't bet)
Seat 5: Takezo1980 folded before Flop (didn't bet)
Seat 6: peterw80 folded before Flop (didn't bet)
Seat 7: willem.lodt folded before Flop (didn't bet)
Seat 8: malik_msk (button) folded before Flop (didn't bet)
Seat 9: AL3X=PRO (small blind) folded before Flop



PokerStars Game #69719084260: Tournament #544010396, $20+$2 USD Hold'em No Limit - Level XXVI (1600/3200) - 2011/10/30 0:47:25 MSK [2011/10/29 16:47:25 ET]
Table '544010396 89' 9-max Seat #9 is the button
Seat 1: triple920 (267107 in chips) 
Seat 2: MskrevFIX (43537 in chips) 
Seat 3: heuler27 (90382 in chips) 
Seat 4: devils_range (58116 in chips) 
Seat 5: Takezo1980 (134451 in chips) 
Seat 6: peterw80 (11414 in chips) 
Seat 7: willem.lodt (51422 in chips) 
Seat 8: malik_msk (109325 in chips) 
Seat 9: AL3X=PRO (73448 in chips) 
triple920: posts the ante 400
MskrevFIX: posts the ante 400
heuler27: posts the ante 400
devils_range: posts the ante 400
Takezo1980: posts the ante 400
peterw80: posts the ante 400
willem.lodt: posts the ante 400
malik_msk: posts the ante 400
AL3X=PRO: posts the ante 400
triple920: posts small blind 1600
MskrevFIX: posts big blind 3200
*** HOLE CARDS ***
Dealt to malik_msk [7d 9s]
heuler27: folds 
devils_range: folds 
Takezo1980: folds 
peterw80 has timed out
peterw80: folds 
peterw80 is sitting out
peterw80 has returned
willem.lodt: folds 
malik_msk: folds 
AL3X=PRO: raises 4159 to 7359
triple920: folds 
MskrevFIX: folds 
Uncalled bet (4159) returned to AL3X=PRO
AL3X=PRO collected 11600 from pot
*** SUMMARY ***
Total pot 11600 | Rake 0 
Seat 1: triple920 (small blind) folded before Flop
Seat 2: MskrevFIX (big blind) folded before Flop
Seat 3: heuler27 folded before Flop (didn't bet)
Seat 4: devils_range folded before Flop (didn't bet)
Seat 5: Takezo1980 folded before Flop (didn't bet)
Seat 6: peterw80 folded before Flop (didn't bet)
Seat 7: willem.lodt folded before Flop (didn't bet)
Seat 8: malik_msk folded before Flop (didn't bet)
Seat 9: AL3X=PRO (button) collected (11600)



PokerStars Game #69719126235: Tournament #544010396, $20+$2 USD Hold'em No Limit - Level XXVI (1600/3200) - 2011/10/30 0:48:13 MSK [2011/10/29 16:48:13 ET]
Table '544010396 89' 9-max Seat #1 is the button
Seat 1: triple920 (265107 in chips) 
Seat 2: MskrevFIX (39937 in chips) 
Seat 3: heuler27 (89982 in chips) 
Seat 4: devils_range (57716 in chips) 
Seat 5: Takezo1980 (134051 in chips) 
Seat 6: peterw80 (11014 in chips) 
Seat 7: willem.lodt (51022 in chips) 
Seat 8: malik_msk (108925 in chips) 
Seat 9: AL3X=PRO (81448 in chips) 
triple920: posts the ante 400
MskrevFIX: posts the ante 400
heuler27: posts the ante 400
devils_range: posts the ante 400
Takezo1980: posts the ante 400
peterw80: posts the ante 400
willem.lodt: posts the ante 400
malik_msk: posts the ante 400
AL3X=PRO: posts the ante 400
MskrevFIX: posts small blind 1600
heuler27: posts big blind 3200
*** HOLE CARDS ***
Dealt to malik_msk [4h Qs]
devils_range: folds 
Takezo1980: folds 
peterw80: folds 
willem.lodt: folds 
malik_msk: folds 
AL3X=PRO: folds 
triple920: raises 6400 to 9600
MskrevFIX: folds 
heuler27: folds 
Uncalled bet (6400) returned to triple920
triple920 collected 11600 from pot
*** SUMMARY ***
Total pot 11600 | Rake 0 
Seat 1: triple920 (button) collected (11600)
Seat 2: MskrevFIX (small blind) folded before Flop
Seat 3: heuler27 (big blind) folded before Flop
Seat 4: devils_range folded before Flop (didn't bet)
Seat 5: Takezo1980 folded before Flop (didn't bet)
Seat 6: peterw80 folded before Flop (didn't bet)
Seat 7: willem.lodt folded before Flop (didn't bet)
Seat 8: malik_msk folded before Flop (didn't bet)
Seat 9: AL3X=PRO folded before Flop (didn't bet)



PokerStars Game #69719165057: Tournament #544010396, $20+$2 USD Hold'em No Limit - Level XXVII (1800/3600) - 2011/10/30 0:48:58 MSK [2011/10/29 16:48:58 ET]
Table '544010396 89' 9-max Seat #2 is the button
Seat 1: triple920 (273107 in chips) 
Seat 2: MskrevFIX (37937 in chips) 
Seat 3: heuler27 (86382 in chips) 
Seat 4: devils_range (57316 in chips) 
Seat 5: Takezo1980 (133651 in chips) 
Seat 6: peterw80 (10614 in chips) 
Seat 7: willem.lodt (50622 in chips) 
Seat 8: malik_msk (108525 in chips) 
Seat 9: AL3X=PRO (81048 in chips) 
triple920: posts the ante 450
MskrevFIX: posts the ante 450
heuler27: posts the ante 450
devils_range: posts the ante 450
Takezo1980: posts the ante 450
peterw80: posts the ante 450
willem.lodt: posts the ante 450
malik_msk: posts the ante 450
AL3X=PRO: posts the ante 450
heuler27: posts small blind 1800
devils_range: posts big blind 3600
*** HOLE CARDS ***
Dealt to malik_msk [6h Jh]
Takezo1980: folds 
peterw80: folds 
willem.lodt: folds 
malik_msk: calls 3600
AL3X=PRO: folds 
triple920: folds 
MskrevFIX: folds 
heuler27: calls 1800
devils_range: checks 
*** FLOP *** [Kd 7c Qh]
heuler27: checks 
devils_range: checks 
malik_msk: checks 
*** TURN *** [Kd 7c Qh] [4h]
heuler27: bets 7200
devils_range: calls 7200
malik_msk: calls 7200
*** RIVER *** [Kd 7c Qh 4h] [2d]
heuler27: checks 
devils_range: checks 
malik_msk: checks 
*** SHOW DOWN ***
heuler27: shows [Ac 2s] (a pair of Deuces)
devils_range: shows [5s Kc] (a pair of Kings)
malik_msk: mucks hand 
devils_range collected 36450 from pot
*** SUMMARY ***
Total pot 36450 | Rake 0 
Board [Kd 7c Qh 4h 2d]
Seat 1: triple920 folded before Flop (didn't bet)
Seat 2: MskrevFIX (button) folded before Flop (didn't bet)
Seat 3: heuler27 (small blind) showed [Ac 2s] and lost with a pair of Deuces
Seat 4: devils_range (big blind) showed [5s Kc] and won (36450) with a pair of Kings
Seat 5: Takezo1980 folded before Flop (didn't bet)
Seat 6: peterw80 folded before Flop (didn't bet)
Seat 7: willem.lodt folded before Flop (didn't bet)
Seat 8: malik_msk mucked [6h Jh]
Seat 9: AL3X=PRO folded before Flop (didn't bet)



PokerStars Game #69719234807: Tournament #544010396, $20+$2 USD Hold'em No Limit - Level XXVII (1800/3600) - 2011/10/30 0:50:19 MSK [2011/10/29 16:50:19 ET]
Table '544010396 89' 9-max Seat #3 is the button
Seat 1: triple920 (272657 in chips) 
Seat 2: MskrevFIX (37487 in chips) 
Seat 3: heuler27 (75132 in chips) 
Seat 4: devils_range (82516 in chips) 
Seat 5: Takezo1980 (133201 in chips) 
Seat 6: peterw80 (10164 in chips) 
Seat 7: willem.lodt (50172 in chips) 
Seat 8: malik_msk (97275 in chips) 
Seat 9: AL3X=PRO (80598 in chips) 
triple920: posts the ante 450
MskrevFIX: posts the ante 450
heuler27: posts the ante 450
devils_range: posts the ante 450
Takezo1980: posts the ante 450
peterw80: posts the ante 450
willem.lodt: posts the ante 450
malik_msk: posts the ante 450
AL3X=PRO: posts the ante 450
devils_range: posts small blind 1800
Takezo1980: posts big blind 3600
*** HOLE CARDS ***
Dealt to malik_msk [8h Ac]
peterw80: raises 6114 to 9714 and is all-in
willem.lodt: folds 
malik_msk: folds 
AL3X=PRO: folds 
triple920: folds 
MskrevFIX: folds 
heuler27: folds 
devils_range: folds 
Takezo1980: calls 6114
*** FLOP *** [8d Ah Th]
*** TURN *** [8d Ah Th] [7c]
*** RIVER *** [8d Ah Th 7c] [Tc]
*** SHOW DOWN ***
Takezo1980: shows [7d 9s] (two pair, Tens and Sevens)
peterw80: shows [As 8c] (two pair, Aces and Tens)
peterw80 collected 25278 from pot
*** SUMMARY ***
Total pot 25278 | Rake 0 
Board [8d Ah Th 7c Tc]
Seat 1: triple920 folded before Flop (didn't bet)
Seat 2: MskrevFIX folded before Flop (didn't bet)
Seat 3: heuler27 (button) folded before Flop (didn't bet)
Seat 4: devils_range (small blind) folded before Flop
Seat 5: Takezo1980 (big blind) showed [7d 9s] and lost with two pair, Tens and Sevens
Seat 6: peterw80 showed [As 8c] and won (25278) with two pair, Aces and Tens
Seat 7: willem.lodt folded before Flop (didn't bet)
Seat 8: malik_msk folded before Flop (didn't bet)
Seat 9: AL3X=PRO folded before Flop (didn't bet)



PokerStars Game #69719272545: Tournament #544010396, $20+$2 USD Hold'em No Limit - Level XXVII (1800/3600) - 2011/10/30 0:51:03 MSK [2011/10/29 16:51:03 ET]
Table '544010396 89' 9-max Seat #4 is the button
Seat 1: triple920 (272207 in chips) 
Seat 2: MskrevFIX (37037 in chips) 
Seat 3: heuler27 (74682 in chips) 
Seat 4: devils_range (80266 in chips) 
Seat 5: Takezo1980 (123037 in chips) 
Seat 6: peterw80 (25278 in chips) 
Seat 7: willem.lodt (49722 in chips) 
Seat 8: malik_msk (96825 in chips) 
Seat 9: AL3X=PRO (80148 in chips) 
triple920: posts the ante 450
MskrevFIX: posts the ante 450
heuler27: posts the ante 450
devils_range: posts the ante 450
Takezo1980: posts the ante 450
peterw80: posts the ante 450
willem.lodt: posts the ante 450
malik_msk: posts the ante 450
AL3X=PRO: posts the ante 450
Takezo1980: posts small blind 1800
peterw80: posts big blind 3600
*** HOLE CARDS ***
Dealt to malik_msk [Ts 2d]
willem.lodt: folds 
malik_msk: folds 
AL3X=PRO: folds 
triple920: folds 
MskrevFIX: raises 32987 to 36587 and is all-in
heuler27: folds 
devils_range: folds 
Takezo1980: folds 
peterw80: folds 
Uncalled bet (32987) returned to MskrevFIX
MskrevFIX collected 13050 from pot
MskrevFIX: doesn't show hand 
*** SUMMARY ***
Total pot 13050 | Rake 0 
Seat 1: triple920 folded before Flop (didn't bet)
Seat 2: MskrevFIX collected (13050)
Seat 3: heuler27 folded before Flop (didn't bet)
Seat 4: devils_range (button) folded before Flop (didn't bet)
Seat 5: Takezo1980 (small blind) folded before Flop
Seat 6: peterw80 (big blind) folded before Flop
Seat 7: willem.lodt folded before Flop (didn't bet)
Seat 8: malik_msk folded before Flop (didn't bet)
Seat 9: AL3X=PRO folded before Flop (didn't bet)



PokerStars Game #69719316689: Tournament #544010396, $20+$2 USD Hold'em No Limit - Level XXVII (1800/3600) - 2011/10/30 0:51:54 MSK [2011/10/29 16:51:54 ET]
Table '544010396 89' 9-max Seat #5 is the button
Seat 1: triple920 (271757 in chips) 
Seat 2: MskrevFIX (46037 in chips) 
Seat 3: heuler27 (74232 in chips) 
Seat 4: devils_range (79816 in chips) 
Seat 5: Takezo1980 (120787 in chips) 
Seat 6: peterw80 (21228 in chips) 
Seat 7: willem.lodt (49272 in chips) 
Seat 8: malik_msk (96375 in chips) 
Seat 9: AL3X=PRO (79698 in chips) 
triple920: posts the ante 450
MskrevFIX: posts the ante 450
heuler27: posts the ante 450
devils_range: posts the ante 450
Takezo1980: posts the ante 450
peterw80: posts the ante 450
willem.lodt: posts the ante 450
malik_msk: posts the ante 450
AL3X=PRO: posts the ante 450
peterw80: posts small blind 1800
willem.lodt: posts big blind 3600
*** HOLE CARDS ***
Dealt to malik_msk [As Qc]
malik_msk: raises 6400 to 10000
AL3X=PRO: folds 
triple920: folds 
MskrevFIX: folds 
heuler27: folds 
devils_range: folds 
Takezo1980: folds 
peterw80: folds 
willem.lodt: folds 
Uncalled bet (6400) returned to malik_msk
malik_msk collected 13050 from pot
malik_msk: doesn't show hand 
*** SUMMARY ***
Total pot 13050 | Rake 0 
Seat 1: triple920 folded before Flop (didn't bet)
Seat 2: MskrevFIX folded before Flop (didn't bet)
Seat 3: heuler27 folded before Flop (didn't bet)
Seat 4: devils_range folded before Flop (didn't bet)
Seat 5: Takezo1980 (button) folded before Flop (didn't bet)
Seat 6: peterw80 (small blind) folded before Flop
Seat 7: willem.lodt (big blind) folded before Flop
Seat 8: malik_msk collected (13050)
Seat 9: AL3X=PRO folded before Flop (didn't bet)



PokerStars Game #69719386666: Tournament #544010396, $20+$2 USD Hold'em No Limit - Level XXVII (1800/3600) - 2011/10/30 0:53:16 MSK [2011/10/29 16:53:16 ET]
Table '544010396 89' 9-max Seat #6 is the button
Seat 1: triple920 (271307 in chips) 
Seat 2: MskrevFIX (45587 in chips) 
Seat 3: heuler27 (73782 in chips) 
Seat 4: devils_range (79366 in chips) 
Seat 6: peterw80 (18978 in chips) 
Seat 7: willem.lodt (45222 in chips) 
Seat 8: malik_msk (105375 in chips) 
Seat 9: AL3X=PRO (79248 in chips) 
triple920: posts the ante 450
MskrevFIX: posts the ante 450
heuler27: posts the ante 450
devils_range: posts the ante 450
peterw80: posts the ante 450
willem.lodt: posts the ante 450
malik_msk: posts the ante 450
AL3X=PRO: posts the ante 450
willem.lodt: posts small blind 1800
malik_msk: posts big blind 3600
*** HOLE CARDS ***
Dealt to malik_msk [2c Tc]
AL3X=PRO: raises 4680 to 8280
triple920: calls 8280
MskrevFIX: raises 36857 to 45137 and is all-in
heuler27: folds 
devils_range: folds 
peterw80: folds 
willem.lodt: folds 
malik_msk: folds 
AL3X=PRO: folds 
triple920: calls 36857
*** FLOP *** [2s Kc 3c]
B1BAX is connected 
*** TURN *** [2s Kc 3c] [2d]
*** RIVER *** [2s Kc 3c 2d] [4s]
*** SHOW DOWN ***
triple920: shows [Kh Qh] (two pair, Kings and Deuces)
MskrevFIX: shows [7s 7c] (two pair, Sevens and Deuces)
triple920 collected 107554 from pot
MskrevFIX finished the tournament in 81st place and received $91.26.
*** SUMMARY ***
Total pot 107554 | Rake 0 
Board [2s Kc 3c 2d 4s]
Seat 1: triple920 showed [Kh Qh] and won (107554) with two pair, Kings and Deuces
Seat 2: MskrevFIX showed [7s 7c] and lost with two pair, Sevens and Deuces
Seat 3: heuler27 folded before Flop (didn't bet)
Seat 4: devils_range folded before Flop (didn't bet)
Seat 6: peterw80 (button) folded before Flop (didn't bet)
Seat 7: willem.lodt (small blind) folded before Flop
Seat 8: malik_msk (big blind) folded before Flop
Seat 9: AL3X=PRO folded before Flop



PokerStars Game #69719463538: Tournament #544010396, $20+$2 USD Hold'em No Limit - Level XXVII (1800/3600) - 2011/10/30 0:54:46 MSK [2011/10/29 16:54:46 ET]
Table '544010396 89' 9-max Seat #7 is the button
Seat 1: triple920 (333274 in chips) 
Seat 3: heuler27 (73332 in chips) 
Seat 4: devils_range (78916 in chips) 
Seat 5: B1BAX (110514 in chips) 
Seat 6: peterw80 (18528 in chips) 
Seat 7: willem.lodt (42972 in chips) 
Seat 8: malik_msk (101325 in chips) 
Seat 9: AL3X=PRO (70518 in chips) 
triple920: posts the ante 450
heuler27: posts the ante 450
devils_range: posts the ante 450
B1BAX: posts the ante 450
peterw80: posts the ante 450
willem.lodt: posts the ante 450
malik_msk: posts the ante 450
AL3X=PRO: posts the ante 450
malik_msk: posts small blind 1800
AL3X=PRO: posts big blind 3600
*** HOLE CARDS ***
Dealt to malik_msk [6h 5h]
triple920: folds 
AL3X=PRO said, "good fold alex :)"
malik_msk said, "T2"
heuler27: folds 
devils_range: folds 
B1BAX: folds 
peterw80: folds 
willem.lodt: folds 
malik_msk said, "was thinking of calling with Doyle's hand"
malik_msk: raises 3600 to 7200
AL3X=PRO said, "lol"
triple920 said, "you call me fold"
AL3X=PRO: calls 3600
*** FLOP *** [6c 3h 3s]
malik_msk: bets 9000
AL3X=PRO: raises 12600 to 21600
devils_range is sitting out
malik_msk said, "u tell me yr hand after fold? :D"
malik_msk has timed out
malik_msk: folds 
Uncalled bet (12600) returned to AL3X=PRO
malik_msk is sitting out
AL3X=PRO collected 36000 from pot
malik_msk has returned
AL3X=PRO: shows [4c 7s] (a pair of Threes)
*** SUMMARY ***
Total pot 36000 | Rake 0 
Board [6c 3h 3s]
Seat 1: triple920 folded before Flop (didn't bet)
Seat 3: heuler27 folded before Flop (didn't bet)
Seat 4: devils_range folded before Flop (didn't bet)
Seat 5: B1BAX folded before Flop (didn't bet)
Seat 6: peterw80 folded before Flop (didn't bet)
Seat 7: willem.lodt (button) folded before Flop (didn't bet)
Seat 8: malik_msk (small blind) folded on the Flop
Seat 9: AL3X=PRO (big blind) collected (36000)



PokerStars Game #69719782968: Tournament #544010396, $20+$2 USD Hold'em No Limit - Level XXVII (1800/3600) - 2011/10/30 1:02:18 MSK [2011/10/29 17:02:18 ET]
Table '544010396 89' 9-max Seat #8 is the button
Seat 1: triple920 (332824 in chips) 
Seat 3: heuler27 (72882 in chips) 
Seat 4: devils_range (78466 in chips) 
Seat 5: B1BAX (110064 in chips) 
Seat 6: peterw80 (18078 in chips) 
Seat 7: willem.lodt (42522 in chips) 
Seat 8: malik_msk (84675 in chips) 
Seat 9: AL3X=PRO (89868 in chips) 
triple920: posts the ante 450
heuler27: posts the ante 450
devils_range: posts the ante 450
B1BAX: posts the ante 450
peterw80: posts the ante 450
willem.lodt: posts the ante 450
malik_msk: posts the ante 450
AL3X=PRO: posts the ante 450
AL3X=PRO: posts small blind 1800
triple920: posts big blind 3600
*** HOLE CARDS ***
Dealt to malik_msk [Jd 4s]
heuler27: folds 
devils_range: raises 4500 to 8100
B1BAX: folds 
peterw80: folds 
willem.lodt: calls 8100
malik_msk: folds 
AL3X=PRO: folds 
triple920: folds 
*** FLOP *** [Kd Kh 7d]
devils_range: checks 
willem.lodt: bets 3600
devils_range: calls 3600
*** TURN *** [Kd Kh 7d] [Qs]
devils_range: checks 
willem.lodt: bets 7200
devils_range: calls 7200
*** RIVER *** [Kd Kh 7d Qs] [Td]
devils_range: checks 
willem.lodt: checks 
*** SHOW DOWN ***
devils_range: shows [Qd Jh] (two pair, Kings and Queens)
willem.lodt: mucks hand 
devils_range collected 46800 from pot
*** SUMMARY ***
Total pot 46800 | Rake 0 
Board [Kd Kh 7d Qs Td]
Seat 1: triple920 (big blind) folded before Flop
Seat 3: heuler27 folded before Flop (didn't bet)
Seat 4: devils_range showed [Qd Jh] and won (46800) with two pair, Kings and Queens
Seat 5: B1BAX folded before Flop (didn't bet)
Seat 6: peterw80 folded before Flop (didn't bet)
Seat 7: willem.lodt mucked [Qc 8c]
Seat 8: malik_msk (button) folded before Flop (didn't bet)
Seat 9: AL3X=PRO (small blind) folded before Flop



PokerStars Game #69719869604: Tournament #544010396, $20+$2 USD Hold'em No Limit - Level XXVII (1800/3600) - 2011/10/30 1:03:57 MSK [2011/10/29 17:03:57 ET]
Table '544010396 89' 9-max Seat #9 is the button
Seat 1: triple920 (328774 in chips) 
Seat 3: heuler27 (72432 in chips) 
Seat 4: devils_range (105916 in chips) 
Seat 5: B1BAX (109614 in chips) 
Seat 6: peterw80 (17628 in chips) 
Seat 7: willem.lodt (23172 in chips) 
Seat 8: malik_msk (84225 in chips) 
Seat 9: AL3X=PRO (87618 in chips) 
triple920: posts the ante 450
heuler27: posts the ante 450
devils_range: posts the ante 450
B1BAX: posts the ante 450
peterw80: posts the ante 450
willem.lodt: posts the ante 450
malik_msk: posts the ante 450
AL3X=PRO: posts the ante 450
triple920: posts small blind 1800
heuler27: posts big blind 3600
*** HOLE CARDS ***
Dealt to malik_msk [5c 3h]
devils_range: folds 
B1BAX: folds 
peterw80: folds 
willem.lodt: raises 19122 to 22722 and is all-in
malik_msk: folds 
AL3X=PRO: folds 
triple920: folds 
heuler27: folds 
Uncalled bet (19122) returned to willem.lodt
willem.lodt collected 12600 from pot
willem.lodt: doesn't show hand 
*** SUMMARY ***
Total pot 12600 | Rake 0 
Seat 1: triple920 (small blind) folded before Flop
Seat 3: heuler27 (big blind) folded before Flop
Seat 4: devils_range folded before Flop (didn't bet)
Seat 5: B1BAX folded before Flop (didn't bet)
Seat 6: peterw80 folded before Flop (didn't bet)
Seat 7: willem.lodt collected (12600)
Seat 8: malik_msk folded before Flop (didn't bet)
Seat 9: AL3X=PRO (button) folded before Flop (didn't bet)



PokerStars Game #69719912480: Tournament #544010396, $20+$2 USD Hold'em No Limit - Level XXVII (1800/3600) - 2011/10/30 1:04:45 MSK [2011/10/29 17:04:45 ET]
Table '544010396 89' 9-max Seat #1 is the button
Seat 1: triple920 (326524 in chips) 
Seat 3: heuler27 (68382 in chips) 
Seat 4: devils_range (105466 in chips) 
Seat 5: B1BAX (109164 in chips) 
Seat 6: peterw80 (17178 in chips) 
Seat 7: willem.lodt (31722 in chips) 
Seat 8: malik_msk (83775 in chips) 
Seat 9: AL3X=PRO (87168 in chips) 
triple920: posts the ante 450
heuler27: posts the ante 450
devils_range: posts the ante 450
B1BAX: posts the ante 450
peterw80: posts the ante 450
willem.lodt: posts the ante 450
malik_msk: posts the ante 450
AL3X=PRO: posts the ante 450
heuler27: posts small blind 1800
devils_range: posts big blind 3600
*** HOLE CARDS ***
Dealt to malik_msk [9h 5c]
Reshafim87 is connected 
B1BAX: folds 
peterw80: folds 
willem.lodt: folds 
malik_msk: folds 
AL3X=PRO: folds 
triple920: folds 
heuler27: calls 1800
devils_range: checks 
*** FLOP *** [Kh Qc 3s]
heuler27: bets 7200
devils_range: folds 
Uncalled bet (7200) returned to heuler27
heuler27 collected 10800 from pot
heuler27: doesn't show hand 
*** SUMMARY ***
Total pot 10800 | Rake 0 
Board [Kh Qc 3s]
Seat 1: triple920 (button) folded before Flop (didn't bet)
Seat 3: heuler27 (small blind) collected (10800)
Seat 4: devils_range (big blind) folded on the Flop
Seat 5: B1BAX folded before Flop (didn't bet)
Seat 6: peterw80 folded before Flop (didn't bet)
Seat 7: willem.lodt folded before Flop (didn't bet)
Seat 8: malik_msk folded before Flop (didn't bet)
Seat 9: AL3X=PRO folded before Flop (didn't bet)



PokerStars Game #69719981125: Tournament #544010396, $20+$2 USD Hold'em No Limit - Level XXVII (1800/3600) - 2011/10/30 1:06:04 MSK [2011/10/29 17:06:04 ET]
Table '544010396 89' 9-max Seat #3 is the button
Seat 1: triple920 (326074 in chips) 
Seat 2: Reshafim87 (285292 in chips) 
Seat 3: heuler27 (75132 in chips) 
Seat 4: devils_range (101416 in chips) 
Seat 5: B1BAX (108714 in chips) 
Seat 6: peterw80 (16728 in chips) 
Seat 7: willem.lodt (31272 in chips) 
Seat 8: malik_msk (83325 in chips) 
Seat 9: AL3X=PRO (86718 in chips) 
triple920: posts the ante 450
Reshafim87: posts the ante 450
heuler27: posts the ante 450
devils_range: posts the ante 450
B1BAX: posts the ante 450
peterw80: posts the ante 450
willem.lodt: posts the ante 450
malik_msk: posts the ante 450
AL3X=PRO: posts the ante 450
devils_range: posts small blind 1800
B1BAX: posts big blind 3600
*** HOLE CARDS ***
Dealt to malik_msk [Jh 6d]
peterw80: raises 12678 to 16278 and is all-in
willem.lodt: folds 
malik_msk: folds 
AL3X=PRO: folds 
triple920: folds 
Reshafim87: folds 
heuler27: folds 
devils_range: folds 
B1BAX: calls 12678
*** FLOP *** [8d 7h 7c]
*** TURN *** [8d 7h 7c] [3c]
*** RIVER *** [8d 7h 7c 3c] [2d]
*** SHOW DOWN ***
B1BAX: shows [8c Ah] (two pair, Eights and Sevens)
peterw80: shows [Ac Kh] (a pair of Sevens)
B1BAX collected 38406 from pot
peterw80 finished the tournament in 71st place and received $97.34.
*** SUMMARY ***
Total pot 38406 | Rake 0 
Board [8d 7h 7c 3c 2d]
Seat 1: triple920 folded before Flop (didn't bet)
Seat 2: Reshafim87 folded before Flop (didn't bet)
Seat 3: heuler27 (button) folded before Flop (didn't bet)
Seat 4: devils_range (small blind) folded before Flop
Seat 5: B1BAX (big blind) showed [8c Ah] and won (38406) with two pair, Eights and Sevens
Seat 6: peterw80 showed [Ac Kh] and lost with a pair of Sevens
Seat 7: willem.lodt folded before Flop (didn't bet)
Seat 8: malik_msk folded before Flop (didn't bet)
Seat 9: AL3X=PRO folded before Flop (didn't bet)



PokerStars Game #69720021852: Tournament #544010396, $20+$2 USD Hold'em No Limit - Level XXVIII (2000/4000) - 2011/10/30 1:06:51 MSK [2011/10/29 17:06:51 ET]
Table '544010396 89' 9-max Seat #4 is the button
Seat 1: triple920 (325624 in chips) 
Seat 2: Reshafim87 (284842 in chips) 
Seat 3: heuler27 (74682 in chips) 
Seat 4: devils_range (99166 in chips) 
Seat 5: B1BAX (130392 in chips) 
Seat 7: willem.lodt (30822 in chips) 
Seat 8: malik_msk (82875 in chips) 
Seat 9: AL3X=PRO (86268 in chips) 
triple920: posts the ante 500
Reshafim87: posts the ante 500
heuler27: posts the ante 500
devils_range: posts the ante 500
B1BAX: posts the ante 500
willem.lodt: posts the ante 500
malik_msk: posts the ante 500
AL3X=PRO: posts the ante 500
B1BAX: posts small blind 2000
willem.lodt: posts big blind 4000
*** HOLE CARDS ***
Dealt to malik_msk [Ts 4d]
malik_msk: folds 
AL3X=PRO: raises 5200 to 9200
triple920: folds 
Reshafim87: folds 
malik_msk said, "gg peter"
heuler27: folds 
devils_range: folds 
B1BAX: folds 
willem.lodt: folds 
Uncalled bet (5200) returned to AL3X=PRO
AL3X=PRO collected 14000 from pot
*** SUMMARY ***
Total pot 14000 | Rake 0 
Seat 1: triple920 folded before Flop (didn't bet)
Seat 2: Reshafim87 folded before Flop (didn't bet)
Seat 3: heuler27 folded before Flop (didn't bet)
Seat 4: devils_range (button) folded before Flop (didn't bet)
Seat 5: B1BAX (small blind) folded before Flop
Seat 7: willem.lodt (big blind) folded before Flop
Seat 8: malik_msk folded before Flop (didn't bet)
Seat 9: AL3X=PRO collected (14000)



PokerStars Game #69720040979: Tournament #544010396, $20+$2 USD Hold'em No Limit - Level XXVIII (2000/4000) - 2011/10/30 1:07:13 MSK [2011/10/29 17:07:13 ET]
Table '544010396 89' 9-max Seat #5 is the button
Seat 1: triple920 (325124 in chips) 
Seat 2: Reshafim87 (284342 in chips) 
Seat 3: heuler27 (74182 in chips) 
Seat 4: devils_range (98666 in chips) 
Seat 5: B1BAX (127892 in chips) 
Seat 7: willem.lodt (26322 in chips) 
Seat 8: malik_msk (82375 in chips) 
Seat 9: AL3X=PRO (95768 in chips) 
triple920: posts the ante 500
Reshafim87: posts the ante 500
heuler27: posts the ante 500
devils_range: posts the ante 500
B1BAX: posts the ante 500
willem.lodt: posts the ante 500
malik_msk: posts the ante 500
AL3X=PRO: posts the ante 500
willem.lodt: posts small blind 2000
malik_msk: posts big blind 4000
*** HOLE CARDS ***
Dealt to malik_msk [9s 6s]
AL3X=PRO: folds 
triple920: folds 
Reshafim87: raises 4000 to 8000
heuler27: folds 
devils_range: folds 
B1BAX: calls 8000
willem.lodt: folds 
malik_msk: calls 4000
*** FLOP *** [6c Qc 9d]
malik_msk: bets 24000
Reshafim87: folds 
B1BAX: raises 40000 to 64000
malik_msk: raises 9875 to 73875 and is all-in
B1BAX: calls 9875
*** TURN *** [6c Qc 9d] [Qh]
*** RIVER *** [6c Qc 9d Qh] [5c]
*** SHOW DOWN ***
malik_msk: shows [9s 6s] (two pair, Queens and Nines)
B1BAX: shows [Ks Qd] (three of a kind, Queens)
B1BAX collected 177750 from pot
malik_msk finished the tournament in 70th place and received $97.34.
AL3X=PRO said, "gg"
*** SUMMARY ***
Total pot 177750 | Rake 0 
Board [6c Qc 9d Qh 5c]
Seat 1: triple920 folded before Flop (didn't bet)
Seat 2: Reshafim87 folded on the Flop
Seat 3: heuler27 folded before Flop (didn't bet)
Seat 4: devils_range folded before Flop (didn't bet)
Seat 5: B1BAX (button) showed [Ks Qd] and won (177750) with three of a kind, Queens
Seat 7: willem.lodt (small blind) folded before Flop
Seat 8: malik_msk (big blind) showed [9s 6s] and lost with two pair, Queens and Nines
Seat 9: AL3X=PRO folded before Flop (didn't bet)



