PokerStars Game #70061795741: Tournament #545010286, $5.00+$0.50 USD Hold'em No Limit - Level I (10/20) - 2011/11/05 16:59:48 MSK [2011/11/05 8:59:48 ET]
Table '545010286 120' 9-max Seat #1 is the button
Seat 1: eanilav (3000 in chips) 
Seat 2: MartinAltman (3000 in chips) 
Seat 3: malik_msk (3000 in chips) 
Seat 4: deki76 (3000 in chips) 
Seat 5: DustHL (3000 in chips) 
Seat 6: andres_osete (3000 in chips) 
Seat 7: Lukexxxi (3000 in chips) 
Seat 8: handra29 (3000 in chips) 
Seat 9: 8Deuce ffs (3000 in chips) 
MartinAltman: posts small blind 10
malik_msk: posts big blind 20
*** HOLE CARDS ***
Dealt to malik_msk [5h Kc]
deki76 has timed out
deki76: folds 
deki76 is sitting out
DustHL: folds 
andres_osete: folds 
Lukexxxi: raises 40 to 60
handra29: folds 
8Deuce ffs: folds 
eanilav: folds 
MartinAltman: calls 50
malik_msk: folds 
*** FLOP *** [5c Ah 4s]
MartinAltman: checks 
Lukexxxi: bets 80
MartinAltman: raises 190 to 270
Lukexxxi: calls 190
*** TURN *** [5c Ah 4s] [Ks]
MartinAltman: bets 410
Lukexxxi: folds 
Uncalled bet (410) returned to MartinAltman
MartinAltman collected 680 from pot
MartinAltman: doesn't show hand 
*** SUMMARY ***
Total pot 680 | Rake 0 
Board [5c Ah 4s Ks]
Seat 1: eanilav (button) folded before Flop (didn't bet)
Seat 2: MartinAltman (small blind) collected (680)
Seat 3: malik_msk (big blind) folded before Flop
Seat 4: deki76 folded before Flop (didn't bet)
Seat 5: DustHL folded before Flop (didn't bet)
Seat 6: andres_osete folded before Flop (didn't bet)
Seat 7: Lukexxxi folded on the Turn
Seat 8: handra29 folded before Flop (didn't bet)
Seat 9: 8Deuce ffs folded before Flop (didn't bet)



PokerStars Game #70061837615: Tournament #545010286, $5.00+$0.50 USD Hold'em No Limit - Level I (10/20) - 2011/11/05 17:01:03 MSK [2011/11/05 9:01:03 ET]
Table '545010286 120' 9-max Seat #2 is the button
Seat 1: eanilav (3000 in chips) 
Seat 2: MartinAltman (3350 in chips) 
Seat 3: malik_msk (2980 in chips) 
Seat 4: deki76 (3000 in chips) is sitting out
Seat 5: DustHL (3000 in chips) 
Seat 6: andres_osete (3000 in chips) 
Seat 7: Lukexxxi (2670 in chips) 
Seat 8: handra29 (3000 in chips) 
Seat 9: 8Deuce ffs (3000 in chips) 
malik_msk: posts small blind 10
deki76: posts big blind 20
*** HOLE CARDS ***
Dealt to malik_msk [2c 4s]
DustHL: calls 20
andres_osete: calls 20
Lukexxxi: folds 
handra29: raises 60 to 80
8Deuce ffs: folds 
eanilav: folds 
MartinAltman: folds 
malik_msk: calls 70
deki76: folds 
DustHL: calls 60
andres_osete: calls 60
*** FLOP *** [5c 9c 8s]
malik_msk: checks 
DustHL: checks 
andres_osete: checks 
handra29: bets 140
malik_msk: folds 
DustHL: calls 140
andres_osete: folds 
*** TURN *** [5c 9c 8s] [3s]
DustHL: checks 
handra29: bets 372
DustHL: folds 
Uncalled bet (372) returned to handra29
handra29 collected 620 from pot
handra29: doesn't show hand 
*** SUMMARY ***
Total pot 620 | Rake 0 
Board [5c 9c 8s 3s]
Seat 1: eanilav folded before Flop (didn't bet)
Seat 2: MartinAltman (button) folded before Flop (didn't bet)
Seat 3: malik_msk (small blind) folded on the Flop
Seat 4: deki76 (big blind) folded before Flop
Seat 5: DustHL folded on the Turn
Seat 6: andres_osete folded on the Flop
Seat 7: Lukexxxi folded before Flop (didn't bet)
Seat 8: handra29 collected (620)
Seat 9: 8Deuce ffs folded before Flop (didn't bet)



PokerStars Game #70061890408: Tournament #545010286, $5.00+$0.50 USD Hold'em No Limit - Level I (10/20) - 2011/11/05 17:02:31 MSK [2011/11/05 9:02:31 ET]
Table '545010286 120' 9-max Seat #3 is the button
Seat 1: eanilav (3000 in chips) 
Seat 2: MartinAltman (3350 in chips) 
Seat 3: malik_msk (2900 in chips) 
Seat 4: deki76 (2980 in chips) is sitting out
Seat 5: DustHL (2780 in chips) 
Seat 6: andres_osete (2920 in chips) 
Seat 7: Lukexxxi (2670 in chips) 
Seat 8: handra29 (3400 in chips) 
Seat 9: 8Deuce ffs (3000 in chips) 
deki76: posts small blind 10
DustHL: posts big blind 20
*** HOLE CARDS ***
Dealt to malik_msk [Qs 9s]
andres_osete: folds 
Lukexxxi: folds 
deki76 has returned
handra29: folds 
8Deuce ffs: folds 
eanilav: folds 
MartinAltman: folds 
malik_msk: raises 40 to 60
deki76: folds 
DustHL: folds 
Uncalled bet (40) returned to malik_msk
malik_msk collected 50 from pot
malik_msk: doesn't show hand 
*** SUMMARY ***
Total pot 50 | Rake 0 
Seat 1: eanilav folded before Flop (didn't bet)
Seat 2: MartinAltman folded before Flop (didn't bet)
Seat 3: malik_msk (button) collected (50)
Seat 4: deki76 (small blind) folded before Flop
Seat 5: DustHL (big blind) folded before Flop
Seat 6: andres_osete folded before Flop (didn't bet)
Seat 7: Lukexxxi folded before Flop (didn't bet)
Seat 8: handra29 folded before Flop (didn't bet)
Seat 9: 8Deuce ffs folded before Flop (didn't bet)



PokerStars Game #70061911461: Tournament #545010286, $5.00+$0.50 USD Hold'em No Limit - Level I (10/20) - 2011/11/05 17:03:03 MSK [2011/11/05 9:03:03 ET]
Table '545010286 120' 9-max Seat #4 is the button
Seat 1: eanilav (3000 in chips) 
Seat 2: MartinAltman (3350 in chips) 
Seat 3: malik_msk (2930 in chips) 
Seat 4: deki76 (2970 in chips) 
Seat 5: DustHL (2760 in chips) 
Seat 6: andres_osete (2920 in chips) 
Seat 7: Lukexxxi (2670 in chips) 
Seat 8: handra29 (3400 in chips) 
Seat 9: 8Deuce ffs (3000 in chips) 
DustHL: posts small blind 10
andres_osete: posts big blind 20
*** HOLE CARDS ***
Dealt to malik_msk [2h 7c]
Lukexxxi: folds 
handra29: folds 
8Deuce ffs: folds 
eanilav: raises 60 to 80
MartinAltman: folds 
malik_msk: folds 
deki76 has timed out
deki76: folds 
deki76 is sitting out
DustHL: calls 70
andres_osete: calls 60
*** FLOP *** [Js 6h Ts]
DustHL: checks 
andres_osete: bets 80
eanilav: calls 80
DustHL: folds 
*** TURN *** [Js 6h Ts] [As]
andres_osete: bets 180
eanilav: raises 180 to 360
andres_osete: calls 180
*** RIVER *** [Js 6h Ts As] [6c]
andres_osete: checks 
deki76 has returned
eanilav: bets 400
andres_osete: raises 400 to 800
eanilav: calls 400
*** SHOW DOWN ***
andres_osete: shows [Ah Tc] (two pair, Aces and Tens)
eanilav: mucks hand 
andres_osete collected 2720 from pot
*** SUMMARY ***
Total pot 2720 | Rake 0 
Board [Js 6h Ts As 6c]
Seat 1: eanilav mucked [9h Ac]
Seat 2: MartinAltman folded before Flop (didn't bet)
Seat 3: malik_msk folded before Flop (didn't bet)
Seat 4: deki76 (button) folded before Flop (didn't bet)
Seat 5: DustHL (small blind) folded on the Flop
Seat 6: andres_osete (big blind) showed [Ah Tc] and won (2720) with two pair, Aces and Tens
Seat 7: Lukexxxi folded before Flop (didn't bet)
Seat 8: handra29 folded before Flop (didn't bet)
Seat 9: 8Deuce ffs folded before Flop (didn't bet)



PokerStars Game #70061984891: Tournament #545010286, $5.00+$0.50 USD Hold'em No Limit - Level I (10/20) - 2011/11/05 17:04:55 MSK [2011/11/05 9:04:55 ET]
Table '545010286 120' 9-max Seat #5 is the button
Seat 1: eanilav (1680 in chips) 
Seat 2: MartinAltman (3350 in chips) 
Seat 3: malik_msk (2930 in chips) 
Seat 4: deki76 (2970 in chips) 
Seat 5: DustHL (2680 in chips) 
Seat 6: andres_osete (4320 in chips) 
Seat 7: Lukexxxi (2670 in chips) 
Seat 8: handra29 (3400 in chips) 
Seat 9: 8Deuce ffs (3000 in chips) 
andres_osete: posts small blind 10
Lukexxxi: posts big blind 20
*** HOLE CARDS ***
Dealt to malik_msk [8h 4h]
handra29: folds 
8Deuce ffs: folds 
eanilav: calls 20
MartinAltman: folds 
malik_msk: calls 20
deki76 has timed out
deki76: folds 
deki76 is sitting out
DustHL: folds 
andres_osete: calls 10
Lukexxxi: checks 
*** FLOP *** [3d 3c Ad]
andres_osete: checks 
Lukexxxi: checks 
eanilav: checks 
malik_msk: checks 
*** TURN *** [3d 3c Ad] [Ac]
andres_osete: checks 
Lukexxxi: checks 
eanilav: bets 120
malik_msk: folds 
andres_osete: folds 
Lukexxxi: folds 
Uncalled bet (120) returned to eanilav
eanilav collected 80 from pot
*** SUMMARY ***
Total pot 80 | Rake 0 
Board [3d 3c Ad Ac]
Seat 1: eanilav collected (80)
Seat 2: MartinAltman folded before Flop (didn't bet)
Seat 3: malik_msk folded on the Turn
Seat 4: deki76 folded before Flop (didn't bet)
Seat 5: DustHL (button) folded before Flop (didn't bet)
Seat 6: andres_osete (small blind) folded on the Turn
Seat 7: Lukexxxi (big blind) folded on the Turn
Seat 8: handra29 folded before Flop (didn't bet)
Seat 9: 8Deuce ffs folded before Flop (didn't bet)



PokerStars Game #70062050566: Tournament #545010286, $5.00+$0.50 USD Hold'em No Limit - Level I (10/20) - 2011/11/05 17:06:35 MSK [2011/11/05 9:06:35 ET]
Table '545010286 120' 9-max Seat #6 is the button
Seat 1: eanilav (1740 in chips) 
Seat 2: MartinAltman (3350 in chips) 
Seat 3: malik_msk (2910 in chips) 
Seat 4: deki76 (2970 in chips) is sitting out
Seat 5: DustHL (2680 in chips) 
Seat 6: andres_osete (4300 in chips) 
Seat 7: Lukexxxi (2650 in chips) 
Seat 8: handra29 (3400 in chips) 
Seat 9: 8Deuce ffs (3000 in chips) 
Lukexxxi: posts small blind 10
handra29: posts big blind 20
*** HOLE CARDS ***
Dealt to malik_msk [3s Qs]
8Deuce ffs: folds 
eanilav: calls 20
MartinAltman: folds 
malik_msk: calls 20
deki76: folds 
DustHL: folds 
andres_osete: folds 
deki76 has returned
Lukexxxi: calls 10
handra29: raises 80 to 100
eanilav: calls 80
malik_msk: calls 80
Lukexxxi: folds 
*** FLOP *** [8c Kh 3h]
handra29: bets 220
eanilav: folds 
malik_msk: calls 220
*** TURN *** [8c Kh 3h] [6s]
handra29: checks 
malik_msk: checks 
*** RIVER *** [8c Kh 3h 6s] [4s]
handra29: bets 380
malik_msk: folds 
Uncalled bet (380) returned to handra29
handra29 collected 760 from pot
*** SUMMARY ***
Total pot 760 | Rake 0 
Board [8c Kh 3h 6s 4s]
Seat 1: eanilav folded on the Flop
Seat 2: MartinAltman folded before Flop (didn't bet)
Seat 3: malik_msk folded on the River
Seat 4: deki76 folded before Flop (didn't bet)
Seat 5: DustHL folded before Flop (didn't bet)
Seat 6: andres_osete (button) folded before Flop (didn't bet)
Seat 7: Lukexxxi (small blind) folded before Flop
Seat 8: handra29 (big blind) collected (760)
Seat 9: 8Deuce ffs folded before Flop (didn't bet)



PokerStars Game #70062169804: Tournament #545010286, $5.00+$0.50 USD Hold'em No Limit - Level I (10/20) - 2011/11/05 17:09:36 MSK [2011/11/05 9:09:36 ET]
Table '545010286 255' 9-max Seat #2 is the button
Seat 1: Abandini (2970 in chips) 
Seat 2: iKinGpin11 (2960 in chips) 
Seat 3: JPJonnes (2975 in chips) 
Seat 4: celfrieling (3072 in chips) 
Seat 5: knecht_poker (3025 in chips) 
Seat 6: monaco2624 (3000 in chips) 
Seat 7: philippe5OO (2970 in chips) 
Seat 8: malik_msk (2590 in chips) 
Seat 9: fradinro (3000 in chips) 
JPJonnes: posts small blind 10
celfrieling: posts big blind 20
*** HOLE CARDS ***
Dealt to malik_msk [Td Jh]
knecht_poker: folds 
monaco2624: folds 
philippe5OO: folds 
malik_msk: raises 40 to 60
fradinro: folds 
Abandini: raises 150 to 210
iKinGpin11: folds 
JPJonnes: folds 
celfrieling: folds 
malik_msk: calls 150
*** FLOP *** [Tc Kh Jc]
malik_msk: checks 
Abandini: checks 
*** TURN *** [Tc Kh Jc] [Th]
malik_msk: checks 
Abandini: bets 60
malik_msk: raises 60 to 120
Abandini: calls 60
*** RIVER *** [Tc Kh Jc Th] [8d]
malik_msk: bets 200
Abandini: calls 200
*** SHOW DOWN ***
malik_msk: shows [Td Jh] (a full house, Tens full of Jacks)
Abandini: mucks hand 
malik_msk collected 1090 from pot
*** SUMMARY ***
Total pot 1090 | Rake 0 
Board [Tc Kh Jc Th 8d]
Seat 1: Abandini mucked [Ac Ad]
Seat 2: iKinGpin11 (button) folded before Flop (didn't bet)
Seat 3: JPJonnes (small blind) folded before Flop
Seat 4: celfrieling (big blind) folded before Flop
Seat 5: knecht_poker folded before Flop (didn't bet)
Seat 6: monaco2624 folded before Flop (didn't bet)
Seat 7: philippe5OO folded before Flop (didn't bet)
Seat 8: malik_msk showed [Td Jh] and won (1090) with a full house, Tens full of Jacks
Seat 9: fradinro folded before Flop (didn't bet)



PokerStars Game #70062212543: Tournament #545010286, $5.00+$0.50 USD Hold'em No Limit - Level II (15/30) - 2011/11/05 17:10:41 MSK [2011/11/05 9:10:41 ET]
Table '545010286 255' 9-max Seat #3 is the button
Seat 1: Abandini (2440 in chips) 
Seat 2: iKinGpin11 (2960 in chips) 
Seat 3: JPJonnes (2965 in chips) 
Seat 4: celfrieling (3052 in chips) 
Seat 6: monaco2624 (3000 in chips) 
Seat 7: philippe5OO (2970 in chips) 
Seat 8: malik_msk (3150 in chips) 
Seat 9: fradinro (3000 in chips) 
celfrieling: posts small blind 15
monaco2624: posts big blind 30
*** HOLE CARDS ***
Dealt to malik_msk [Tc Kd]
alex150372 is connected 
philippe5OO: folds 
malik_msk: calls 30
fradinro: calls 30
Abandini: folds 
iKinGpin11: folds 
JPJonnes: calls 30
celfrieling: raises 150 to 180
monaco2624: folds 
Abandini said, "lost aa 80% of time the last 4 weeks..ty stars"
malik_msk: calls 150
fradinro: calls 150
JPJonnes: folds 
*** FLOP *** [2s 8d 3h]
celfrieling: bets 360
malik_msk said, "I hate AK also"
malik_msk: folds 
fradinro: calls 360
*** TURN *** [2s 8d 3h] [3c]
malik_msk said, "for the same reason"
celfrieling: bets 792
fradinro: calls 792
*** RIVER *** [2s 8d 3h 3c] [6d]
celfrieling: bets 1720 and is all-in
fradinro: calls 1668 and is all-in
Uncalled bet (52) returned to celfrieling
*** SHOW DOWN ***
celfrieling: shows [Jc Js] (two pair, Jacks and Threes)
fradinro: shows [6c 4d] (two pair, Sixes and Threes)
celfrieling collected 6240 from pot
fradinro finished the tournament in 2394th place
*** SUMMARY ***
Total pot 6240 | Rake 0 
Board [2s 8d 3h 3c 6d]
Seat 1: Abandini folded before Flop (didn't bet)
Seat 2: iKinGpin11 folded before Flop (didn't bet)
Seat 3: JPJonnes (button) folded before Flop
Seat 4: celfrieling (small blind) showed [Jc Js] and won (6240) with two pair, Jacks and Threes
Seat 6: monaco2624 (big blind) folded before Flop
Seat 7: philippe5OO folded before Flop (didn't bet)
Seat 8: malik_msk folded on the Flop
Seat 9: fradinro showed [6c 4d] and lost with two pair, Sixes and Threes



PokerStars Game #70062258808: Tournament #545010286, $5.00+$0.50 USD Hold'em No Limit - Level II (15/30) - 2011/11/05 17:11:51 MSK [2011/11/05 9:11:51 ET]
Table '545010286 255' 9-max Seat #4 is the button
Seat 1: Abandini (2440 in chips) 
Seat 2: iKinGpin11 (2960 in chips) 
Seat 3: JPJonnes (2935 in chips) 
Seat 4: celfrieling (6292 in chips) 
Seat 5: alex150372 (3000 in chips) out of hand (moved from another table into small blind)
Seat 6: monaco2624 (2970 in chips) 
Seat 7: Dexter127 (3120 in chips) 
Seat 8: malik_msk (2970 in chips) 
Seat 9: HackNga$ (3000 in chips) 
monaco2624: posts small blind 15
Dexter127: posts big blind 30
*** HOLE CARDS ***
Dealt to malik_msk [5c 9c]
malik_msk: calls 30
HackNga$: raises 90 to 120
Abandini: folds 
iKinGpin11: folds 
JPJonnes: folds 
celfrieling: folds 
monaco2624: folds 
Dexter127: folds 
malik_msk: calls 90
*** FLOP *** [Ah 5h 7d]
malik_msk: checks 
HackNga$: bets 180
malik_msk: raises 180 to 360
HackNga$: calls 180
*** TURN *** [Ah 5h 7d] [5s]
malik_msk: bets 510
HackNga$: calls 510
*** RIVER *** [Ah 5h 7d 5s] [2s]
malik_msk: bets 1410
HackNga$: folds 
Uncalled bet (1410) returned to malik_msk
malik_msk collected 2025 from pot
malik_msk: doesn't show hand 
*** SUMMARY ***
Total pot 2025 | Rake 0 
Board [Ah 5h 7d 5s 2s]
Seat 1: Abandini folded before Flop (didn't bet)
Seat 2: iKinGpin11 folded before Flop (didn't bet)
Seat 3: JPJonnes folded before Flop (didn't bet)
Seat 4: celfrieling (button) folded before Flop (didn't bet)
Seat 6: monaco2624 (small blind) folded before Flop
Seat 7: Dexter127 (big blind) folded before Flop
Seat 8: malik_msk collected (2025)
Seat 9: HackNga$ folded on the River



PokerStars Game #70062306828: Tournament #545010286, $5.00+$0.50 USD Hold'em No Limit - Level II (15/30) - 2011/11/05 17:13:05 MSK [2011/11/05 9:13:05 ET]
Table '545010286 255' 9-max Seat #6 is the button
Seat 1: Abandini (2440 in chips) 
Seat 2: iKinGpin11 (2960 in chips) 
Seat 3: JPJonnes (2935 in chips) 
Seat 4: celfrieling (6292 in chips) 
Seat 5: alex150372 (3000 in chips) 
Seat 6: monaco2624 (2955 in chips) 
Seat 7: Dexter127 (3090 in chips) 
Seat 8: malik_msk (4005 in chips) 
Seat 9: HackNga$ (2010 in chips) 
Dexter127: posts small blind 15
malik_msk: posts big blind 30
*** HOLE CARDS ***
Dealt to malik_msk [2s 4s]
HackNga$: raises 180 to 210
Abandini: folds 
iKinGpin11: raises 180 to 390
JPJonnes: folds 
celfrieling: folds 
alex150372: folds 
monaco2624: folds 
Dexter127: folds 
malik_msk: folds 
HackNga$: raises 1620 to 2010 and is all-in
iKinGpin11: calls 1620
*** FLOP *** [8c 6c 2d]
*** TURN *** [8c 6c 2d] [8d]
*** RIVER *** [8c 6c 2d 8d] [3h]
*** SHOW DOWN ***
HackNga$: shows [Ts Th] (two pair, Tens and Eights)
iKinGpin11: shows [Kh Ah] (a pair of Eights)
HackNga$ collected 4065 from pot
*** SUMMARY ***
Total pot 4065 | Rake 0 
Board [8c 6c 2d 8d 3h]
Seat 1: Abandini folded before Flop (didn't bet)
Seat 2: iKinGpin11 showed [Kh Ah] and lost with a pair of Eights
Seat 3: JPJonnes folded before Flop (didn't bet)
Seat 4: celfrieling folded before Flop (didn't bet)
Seat 5: alex150372 folded before Flop (didn't bet)
Seat 6: monaco2624 (button) folded before Flop (didn't bet)
Seat 7: Dexter127 (small blind) folded before Flop
Seat 8: malik_msk (big blind) folded before Flop
Seat 9: HackNga$ showed [Ts Th] and won (4065) with two pair, Tens and Eights



PokerStars Game #70062338892: Tournament #545010286, $5.00+$0.50 USD Hold'em No Limit - Level II (15/30) - 2011/11/05 17:13:54 MSK [2011/11/05 9:13:54 ET]
Table '545010286 255' 9-max Seat #7 is the button
Seat 1: Abandini (2440 in chips) 
Seat 2: iKinGpin11 (950 in chips) 
Seat 3: JPJonnes (2935 in chips) 
Seat 4: celfrieling (6292 in chips) 
Seat 5: alex150372 (3000 in chips) 
Seat 6: monaco2624 (2955 in chips) 
Seat 7: Dexter127 (3075 in chips) 
Seat 8: malik_msk (3975 in chips) 
Seat 9: HackNga$ (4065 in chips) 
malik_msk: posts small blind 15
HackNga$: posts big blind 30
*** HOLE CARDS ***
Dealt to malik_msk [2c 2d]
Abandini: folds 
iKinGpin11: folds 
JPJonnes: folds 
celfrieling: raises 60 to 90
alex150372: calls 90
monaco2624: folds 
Dexter127: calls 90
malik_msk: calls 75
HackNga$: calls 60
*** FLOP *** [9s Jd 9d]
malik_msk: checks 
HackNga$: bets 150
celfrieling: calls 150
alex150372: calls 150
Dexter127: raises 2835 to 2985 and is all-in
malik_msk: folds 
HackNga$: raises 990 to 3975 and is all-in
celfrieling: folds 
alex150372: folds 
Uncalled bet (990) returned to HackNga$
*** TURN *** [9s Jd 9d] [6s]
*** RIVER *** [9s Jd 9d 6s] [Tc]
*** SHOW DOWN ***
HackNga$: shows [9c Ts] (a full house, Nines full of Tens)
Dexter127: shows [Jh Kh] (two pair, Jacks and Nines)
HackNga$ collected 6720 from pot
Dexter127 finished the tournament in 2498th place
VodkaForMe is connected 
*** SUMMARY ***
Total pot 6720 | Rake 0 
Board [9s Jd 9d 6s Tc]
Seat 1: Abandini folded before Flop (didn't bet)
Seat 2: iKinGpin11 folded before Flop (didn't bet)
Seat 3: JPJonnes folded before Flop (didn't bet)
Seat 4: celfrieling folded on the Flop
Seat 5: alex150372 folded on the Flop
Seat 6: monaco2624 folded before Flop (didn't bet)
Seat 7: Dexter127 (button) showed [Jh Kh] and lost with two pair, Jacks and Nines
Seat 8: malik_msk (small blind) folded on the Flop
Seat 9: HackNga$ (big blind) showed [9c Ts] and won (6720) with a full house, Nines full of Tens



PokerStars Game #70062397271: Tournament #545010286, $5.00+$0.50 USD Hold'em No Limit - Level II (15/30) - 2011/11/05 17:15:22 MSK [2011/11/05 9:15:22 ET]
Table '545010286 255' 9-max Seat #8 is the button
Seat 1: Abandini (2440 in chips) 
Seat 2: iKinGpin11 (950 in chips) 
Seat 3: JPJonnes (2935 in chips) 
Seat 4: celfrieling (6052 in chips) 
Seat 5: alex150372 (2760 in chips) 
Seat 6: monaco2624 (2955 in chips) 
Seat 7: VodkaForMe (3000 in chips) 
Seat 8: malik_msk (3885 in chips) 
Seat 9: HackNga$ (7710 in chips) 
HackNga$: posts small blind 15
Abandini: posts big blind 30
*** HOLE CARDS ***
Dealt to malik_msk [Ad Kc]
iKinGpin11: raises 920 to 950 and is all-in
JPJonnes: folds 
celfrieling: folds 
alex150372: folds 
monaco2624: folds 
VodkaForMe: folds 
malik_msk: raises 920 to 1870
HackNga$: raises 5840 to 7710 and is all-in
Abandini: folds 
malik_msk: calls 2015 and is all-in
Uncalled bet (3825) returned to HackNga$
*** FLOP *** [3h 2d Jd]
*** TURN *** [3h 2d Jd] [Ac]
*** RIVER *** [3h 2d Jd Ac] [Ah]
*** SHOW DOWN ***
HackNga$: shows [7h 8d] (a pair of Aces)
malik_msk: shows [Ad Kc] (three of a kind, Aces)
malik_msk collected 5870 from side pot
iKinGpin11: shows [Qd 6d] (a pair of Aces)
malik_msk collected 2880 from main pot
iKinGpin11 finished the tournament in 2533rd place
*** SUMMARY ***
Total pot 8750 Main pot 2880. Side pot 5870. | Rake 0 
Board [3h 2d Jd Ac Ah]
Seat 1: Abandini (big blind) folded before Flop
Seat 2: iKinGpin11 showed [Qd 6d] and lost with a pair of Aces
Seat 3: JPJonnes folded before Flop (didn't bet)
Seat 4: celfrieling folded before Flop (didn't bet)
Seat 5: alex150372 folded before Flop (didn't bet)
Seat 6: monaco2624 folded before Flop (didn't bet)
Seat 7: VodkaForMe folded before Flop (didn't bet)
Seat 8: malik_msk (button) showed [Ad Kc] and won (8750) with three of a kind, Aces
Seat 9: HackNga$ (small blind) showed [7h 8d] and lost with a pair of Aces



PokerStars Game #70062431118: Tournament #545010286, $5.00+$0.50 USD Hold'em No Limit - Level II (15/30) - 2011/11/05 17:16:13 MSK [2011/11/05 9:16:13 ET]
Table '545010286 255' 9-max Seat #9 is the button
Seat 1: Abandini (2410 in chips) 
Seat 2: lepa888 (3000 in chips) 
Seat 3: JPJonnes (2935 in chips) 
Seat 4: celfrieling (6052 in chips) 
Seat 5: alex150372 (2760 in chips) 
Seat 6: monaco2624 (2955 in chips) 
Seat 7: VodkaForMe (3000 in chips) 
Seat 8: malik_msk (8750 in chips) 
Seat 9: HackNga$ (3825 in chips) 
Abandini: posts small blind 15
lepa888: posts big blind 30
*** HOLE CARDS ***
Dealt to malik_msk [3c Ah]
JPJonnes: folds 
celfrieling: folds 
alex150372: calls 30
monaco2624: raises 30 to 60
VodkaForMe: folds 
malik_msk: calls 60
HackNga$: calls 60
Abandini: calls 45
lepa888: calls 30
alex150372: calls 30
*** FLOP *** [5h Kh Kc]
Abandini: checks 
lepa888: checks 
alex150372: checks 
monaco2624: checks 
malik_msk: checks 
HackNga$: checks 
*** TURN *** [5h Kh Kc] [8s]
Abandini: bets 180
lepa888: folds 
alex150372: folds 
monaco2624: calls 180
malik_msk: folds 
HackNga$: folds 
*** RIVER *** [5h Kh Kc 8s] [7h]
Abandini: checks 
monaco2624: bets 180
Abandini: calls 180
*** SHOW DOWN ***
monaco2624: shows [4h 3h] (a flush, King high)
Abandini: mucks hand 
monaco2624 collected 1080 from pot
*** SUMMARY ***
Total pot 1080 | Rake 0 
Board [5h Kh Kc 8s 7h]
Seat 1: Abandini (small blind) mucked [Kd Td]
Seat 2: lepa888 (big blind) folded on the Turn
Seat 3: JPJonnes folded before Flop (didn't bet)
Seat 4: celfrieling folded before Flop (didn't bet)
Seat 5: alex150372 folded on the Turn
Seat 6: monaco2624 showed [4h 3h] and won (1080) with a flush, King high
Seat 7: VodkaForMe folded before Flop (didn't bet)
Seat 8: malik_msk folded on the Turn
Seat 9: HackNga$ (button) folded on the Turn



PokerStars Game #70062488416: Tournament #545010286, $5.00+$0.50 USD Hold'em No Limit - Level II (15/30) - 2011/11/05 17:17:39 MSK [2011/11/05 9:17:39 ET]
Table '545010286 255' 9-max Seat #1 is the button
Seat 1: Abandini (1990 in chips) 
Seat 2: lepa888 (2940 in chips) 
Seat 3: JPJonnes (2935 in chips) 
Seat 4: celfrieling (6052 in chips) 
Seat 5: alex150372 (2700 in chips) 
Seat 6: monaco2624 (3615 in chips) 
Seat 7: VodkaForMe (3000 in chips) 
Seat 8: malik_msk (8690 in chips) 
Seat 9: HackNga$ (3765 in chips) 
lepa888: posts small blind 15
JPJonnes: posts big blind 30
*** HOLE CARDS ***
Dealt to malik_msk [3h 7d]
celfrieling: folds 
alex150372: folds 
monaco2624: raises 30 to 60
VodkaForMe: folds 
malik_msk: folds 
HackNga$: calls 60
Abandini: folds 
lepa888: calls 45
JPJonnes: calls 30
*** FLOP *** [5h Ad 9s]
lepa888: checks 
JPJonnes: checks 
monaco2624: checks 
HackNga$: checks 
*** TURN *** [5h Ad 9s] [Th]
lepa888: checks 
JPJonnes: checks 
monaco2624: checks 
HackNga$: checks 
*** RIVER *** [5h Ad 9s Th] [4h]
lepa888: checks 
JPJonnes: checks 
monaco2624: bets 60
HackNga$: calls 60
lepa888: folds 
JPJonnes: calls 60
*** SHOW DOWN ***
monaco2624: shows [As 4s] (two pair, Aces and Fours)
HackNga$: mucks hand 
JPJonnes: mucks hand 
monaco2624 collected 420 from pot
*** SUMMARY ***
Total pot 420 | Rake 0 
Board [5h Ad 9s Th 4h]
Seat 1: Abandini (button) folded before Flop (didn't bet)
Seat 2: lepa888 (small blind) folded on the River
Seat 3: JPJonnes (big blind) mucked [Tc Qs]
Seat 4: celfrieling folded before Flop (didn't bet)
Seat 5: alex150372 folded before Flop (didn't bet)
Seat 6: monaco2624 showed [As 4s] and won (420) with two pair, Aces and Fours
Seat 7: VodkaForMe folded before Flop (didn't bet)
Seat 8: malik_msk folded before Flop (didn't bet)
Seat 9: HackNga$ mucked [4d Jd]



PokerStars Game #70062538078: Tournament #545010286, $5.00+$0.50 USD Hold'em No Limit - Level II (15/30) - 2011/11/05 17:18:54 MSK [2011/11/05 9:18:54 ET]
Table '545010286 255' 9-max Seat #2 is the button
Seat 1: Abandini (1990 in chips) 
Seat 2: lepa888 (2880 in chips) 
Seat 3: JPJonnes (2815 in chips) 
Seat 4: celfrieling (6052 in chips) 
Seat 5: alex150372 (2700 in chips) 
Seat 6: monaco2624 (3915 in chips) 
Seat 7: VodkaForMe (3000 in chips) 
Seat 8: malik_msk (8690 in chips) 
Seat 9: HackNga$ (3645 in chips) 
JPJonnes: posts small blind 15
celfrieling: posts big blind 30
*** HOLE CARDS ***
Dealt to malik_msk [6d 7d]
alex150372: folds 
monaco2624: raises 60 to 90
VodkaForMe: folds 
malik_msk: calls 90
HackNga$: raises 3555 to 3645 and is all-in
Abandini: folds 
lepa888: folds 
JPJonnes: calls 2800 and is all-in
celfrieling: folds 
monaco2624: folds 
malik_msk: folds 
Uncalled bet (830) returned to HackNga$
*** FLOP *** [Kh 8c 8s]
*** TURN *** [Kh 8c 8s] [5d]
*** RIVER *** [Kh 8c 8s 5d] [3h]
*** SHOW DOWN ***
JPJonnes: shows [Kd Qd] (two pair, Kings and Eights)
HackNga$: shows [Ts Tc] (two pair, Tens and Eights)
JPJonnes collected 5840 from pot
*** SUMMARY ***
Total pot 5840 | Rake 0 
Board [Kh 8c 8s 5d 3h]
Seat 1: Abandini folded before Flop (didn't bet)
Seat 2: lepa888 (button) folded before Flop (didn't bet)
Seat 3: JPJonnes (small blind) showed [Kd Qd] and won (5840) with two pair, Kings and Eights
Seat 4: celfrieling (big blind) folded before Flop
Seat 5: alex150372 folded before Flop (didn't bet)
Seat 6: monaco2624 folded before Flop
Seat 7: VodkaForMe folded before Flop (didn't bet)
Seat 8: malik_msk folded before Flop
Seat 9: HackNga$ showed [Ts Tc] and lost with two pair, Tens and Eights



PokerStars Game #70062565581: Tournament #545010286, $5.00+$0.50 USD Hold'em No Limit - Level II (15/30) - 2011/11/05 17:19:35 MSK [2011/11/05 9:19:35 ET]
Table '545010286 255' 9-max Seat #3 is the button
Seat 1: Abandini (1990 in chips) 
Seat 2: lepa888 (2880 in chips) 
Seat 3: JPJonnes (5840 in chips) 
Seat 4: celfrieling (6022 in chips) 
Seat 5: alex150372 (2700 in chips) 
Seat 6: monaco2624 (3825 in chips) 
Seat 7: VodkaForMe (3000 in chips) 
Seat 8: malik_msk (8600 in chips) 
Seat 9: HackNga$ (830 in chips) 
celfrieling: posts small blind 15
alex150372: posts big blind 30
*** HOLE CARDS ***
Dealt to malik_msk [4d 4s]
monaco2624: folds 
VodkaForMe: raises 60 to 90
malik_msk: calls 90
HackNga$: folds 
Abandini: folds 
lepa888: calls 90
JPJonnes: folds 
celfrieling: folds 
alex150372: folds 
*** FLOP *** [As 3s 2c]
VodkaForMe: checks 
malik_msk: bets 60
lepa888: calls 60
VodkaForMe: folds 
*** TURN *** [As 3s 2c] [9c]
malik_msk: bets 90
lepa888: calls 90
*** RIVER *** [As 3s 2c 9c] [Qc]
malik_msk: bets 150
lepa888: folds 
Uncalled bet (150) returned to malik_msk
malik_msk collected 615 from pot
malik_msk: doesn't show hand 
*** SUMMARY ***
Total pot 615 | Rake 0 
Board [As 3s 2c 9c Qc]
Seat 1: Abandini folded before Flop (didn't bet)
Seat 2: lepa888 folded on the River
Seat 3: JPJonnes (button) folded before Flop (didn't bet)
Seat 4: celfrieling (small blind) folded before Flop
Seat 5: alex150372 (big blind) folded before Flop
Seat 6: monaco2624 folded before Flop (didn't bet)
Seat 7: VodkaForMe folded on the Flop
Seat 8: malik_msk collected (615)
Seat 9: HackNga$ folded before Flop (didn't bet)



PokerStars Game #70062612301: Tournament #545010286, $5.00+$0.50 USD Hold'em No Limit - Level III (20/40) - 2011/11/05 17:20:46 MSK [2011/11/05 9:20:46 ET]
Table '545010286 255' 9-max Seat #4 is the button
Seat 1: Abandini (1990 in chips) 
Seat 2: lepa888 (2640 in chips) 
Seat 3: JPJonnes (5840 in chips) 
Seat 4: celfrieling (6007 in chips) 
Seat 5: alex150372 (2670 in chips) 
Seat 6: monaco2624 (3825 in chips) 
Seat 7: VodkaForMe (2910 in chips) 
Seat 8: malik_msk (8975 in chips) 
Seat 9: HackNga$ (830 in chips) 
alex150372: posts small blind 20
monaco2624: posts big blind 40
*** HOLE CARDS ***
Dealt to malik_msk [Kh Qc]
VodkaForMe: folds 
malik_msk: calls 40
HackNga$: folds 
Abandini: calls 40
lepa888: folds 
JPJonnes: folds 
celfrieling: folds 
alex150372: folds 
monaco2624: checks 
*** FLOP *** [3h 9d 2s]
monaco2624: checks 
malik_msk: checks 
Abandini: checks 
*** TURN *** [3h 9d 2s] [3c]
monaco2624: checks 
malik_msk: bets 40
Abandini: calls 40
monaco2624: folds 
*** RIVER *** [3h 9d 2s 3c] [Qs]
malik_msk: bets 40
Abandini: calls 40
*** SHOW DOWN ***
malik_msk: shows [Kh Qc] (two pair, Queens and Threes)
Abandini: mucks hand 
malik_msk collected 300 from pot
*** SUMMARY ***
Total pot 300 | Rake 0 
Board [3h 9d 2s 3c Qs]
Seat 1: Abandini mucked [6d 6s]
Seat 2: lepa888 folded before Flop (didn't bet)
Seat 3: JPJonnes folded before Flop (didn't bet)
Seat 4: celfrieling (button) folded before Flop (didn't bet)
Seat 5: alex150372 (small blind) folded before Flop
Seat 6: monaco2624 (big blind) folded on the Turn
Seat 7: VodkaForMe folded before Flop (didn't bet)
Seat 8: malik_msk showed [Kh Qc] and won (300) with two pair, Queens and Threes
Seat 9: HackNga$ folded before Flop (didn't bet)



PokerStars Game #70062645405: Tournament #545010286, $5.00+$0.50 USD Hold'em No Limit - Level III (20/40) - 2011/11/05 17:21:35 MSK [2011/11/05 9:21:35 ET]
Table '545010286 255' 9-max Seat #5 is the button
Seat 1: Abandini (1870 in chips) 
Seat 2: lepa888 (2640 in chips) 
Seat 3: JPJonnes (5840 in chips) 
Seat 4: celfrieling (6007 in chips) 
Seat 5: alex150372 (2650 in chips) 
Seat 6: monaco2624 (3785 in chips) 
Seat 7: VodkaForMe (2910 in chips) 
Seat 8: malik_msk (9155 in chips) 
Seat 9: HackNga$ (830 in chips) 
monaco2624: posts small blind 20
VodkaForMe: posts big blind 40
*** HOLE CARDS ***
Dealt to malik_msk [Kh Ad]
malik_msk: calls 40
HackNga$: raises 790 to 830 and is all-in
Abandini: folds 
lepa888: folds 
JPJonnes: folds 
celfrieling: folds 
alex150372: folds 
monaco2624: folds 
alex150372 is sitting out
VodkaForMe: folds 
malik_msk: calls 790
*** FLOP *** [4c 8c As]
*** TURN *** [4c 8c As] [Qs]
*** RIVER *** [4c 8c As Qs] [Jc]
*** SHOW DOWN ***
malik_msk: shows [Kh Ad] (a pair of Aces)
HackNga$: shows [8h Jh] (two pair, Jacks and Eights)
HackNga$ collected 1720 from pot
*** SUMMARY ***
Total pot 1720 | Rake 0 
Board [4c 8c As Qs Jc]
Seat 1: Abandini folded before Flop (didn't bet)
Seat 2: lepa888 folded before Flop (didn't bet)
Seat 3: JPJonnes folded before Flop (didn't bet)
Seat 4: celfrieling folded before Flop (didn't bet)
Seat 5: alex150372 (button) folded before Flop (didn't bet)
Seat 6: monaco2624 (small blind) folded before Flop
Seat 7: VodkaForMe (big blind) folded before Flop
Seat 8: malik_msk showed [Kh Ad] and lost with a pair of Aces
Seat 9: HackNga$ showed [8h Jh] and won (1720) with two pair, Jacks and Eights



PokerStars Game #70062670009: Tournament #545010286, $5.00+$0.50 USD Hold'em No Limit - Level III (20/40) - 2011/11/05 17:22:11 MSK [2011/11/05 9:22:11 ET]
Table '545010286 255' 9-max Seat #6 is the button
Seat 1: Abandini (1870 in chips) 
Seat 2: lepa888 (2640 in chips) 
Seat 3: JPJonnes (5840 in chips) 
Seat 4: celfrieling (6007 in chips) 
Seat 5: alex150372 (2650 in chips) is sitting out
Seat 6: monaco2624 (3765 in chips) 
Seat 7: VodkaForMe (2870 in chips) 
Seat 8: malik_msk (8325 in chips) 
Seat 9: HackNga$ (1720 in chips) 
VodkaForMe: posts small blind 20
malik_msk: posts big blind 40
*** HOLE CARDS ***
Dealt to malik_msk [2d 3s]
HackNga$: raises 80 to 120
Abandini: folds 
lepa888: folds 
JPJonnes: folds 
celfrieling: folds 
alex150372: folds 
monaco2624: folds 
VodkaForMe: calls 100
malik_msk: calls 80
*** FLOP *** [Td 8c Jd]
VodkaForMe: checks 
malik_msk: folds 
HackNga$: checks 
*** TURN *** [Td 8c Jd] [Qh]
VodkaForMe: checks 
HackNga$: bets 200
VodkaForMe: raises 200 to 400
HackNga$: raises 1200 to 1600 and is all-in
VodkaForMe: folds 
Uncalled bet (1200) returned to HackNga$
HackNga$ collected 1160 from pot
HackNga$: doesn't show hand 
*** SUMMARY ***
Total pot 1160 | Rake 0 
Board [Td 8c Jd Qh]
Seat 1: Abandini folded before Flop (didn't bet)
Seat 2: lepa888 folded before Flop (didn't bet)
Seat 3: JPJonnes folded before Flop (didn't bet)
Seat 4: celfrieling folded before Flop (didn't bet)
Seat 5: alex150372 folded before Flop (didn't bet)
Seat 6: monaco2624 (button) folded before Flop (didn't bet)
Seat 7: VodkaForMe (small blind) folded on the Turn
Seat 8: malik_msk (big blind) folded on the Flop
Seat 9: HackNga$ collected (1160)



PokerStars Game #70062725373: Tournament #545010286, $5.00+$0.50 USD Hold'em No Limit - Level III (20/40) - 2011/11/05 17:23:32 MSK [2011/11/05 9:23:32 ET]
Table '545010286 255' 9-max Seat #7 is the button
Seat 1: Abandini (1870 in chips) 
Seat 2: lepa888 (2640 in chips) 
Seat 3: JPJonnes (5840 in chips) 
Seat 4: celfrieling (6007 in chips) 
Seat 5: alex150372 (2650 in chips) is sitting out
Seat 6: monaco2624 (3765 in chips) 
Seat 7: VodkaForMe (2350 in chips) 
Seat 8: malik_msk (8205 in chips) 
Seat 9: HackNga$ (2360 in chips) 
malik_msk: posts small blind 20
HackNga$: posts big blind 40
*** HOLE CARDS ***
Dealt to malik_msk [Jc Ks]
Abandini: folds 
lepa888: raises 40 to 80
JPJonnes: folds 
celfrieling: folds 
alex150372: folds 
monaco2624: folds 
VodkaForMe: raises 2270 to 2350 and is all-in
malik_msk: calls 2330
HackNga$: folds 
lepa888: raises 290 to 2640 and is all-in
malik_msk: calls 290
*** FLOP *** [Jd Ts 6h]
*** TURN *** [Jd Ts 6h] [9d]
*** RIVER *** [Jd Ts 6h 9d] [5h]
*** SHOW DOWN ***
malik_msk: shows [Jc Ks] (a pair of Jacks)
lepa888: shows [Qh Qd] (a pair of Queens)
lepa888 collected 580 from side pot
VodkaForMe: shows [6s 6d] (three of a kind, Sixes)
VodkaForMe collected 7090 from main pot
*** SUMMARY ***
Total pot 7670 Main pot 7090. Side pot 580. | Rake 0 
Board [Jd Ts 6h 9d 5h]
Seat 1: Abandini folded before Flop (didn't bet)
Seat 2: lepa888 showed [Qh Qd] and won (580) with a pair of Queens
Seat 3: JPJonnes folded before Flop (didn't bet)
Seat 4: celfrieling folded before Flop (didn't bet)
Seat 5: alex150372 folded before Flop (didn't bet)
Seat 6: monaco2624 folded before Flop (didn't bet)
Seat 7: VodkaForMe (button) showed [6s 6d] and won (7090) with three of a kind, Sixes
Seat 8: malik_msk (small blind) showed [Jc Ks] and lost with a pair of Jacks
Seat 9: HackNga$ (big blind) folded before Flop



PokerStars Game #70062760080: Tournament #545010286, $5.00+$0.50 USD Hold'em No Limit - Level III (20/40) - 2011/11/05 17:24:23 MSK [2011/11/05 9:24:23 ET]
Table '545010286 255' 9-max Seat #8 is the button
Seat 1: Abandini (1870 in chips) 
Seat 2: lepa888 (580 in chips) 
Seat 3: JPJonnes (5840 in chips) 
Seat 4: celfrieling (6007 in chips) 
Seat 5: alex150372 (2650 in chips) is sitting out
Seat 6: monaco2624 (3765 in chips) 
Seat 7: VodkaForMe (7090 in chips) 
Seat 8: malik_msk (5565 in chips) 
Seat 9: HackNga$ (2320 in chips) 
HackNga$: posts small blind 20
Abandini: posts big blind 40
*** HOLE CARDS ***
Dealt to malik_msk [9s 8s]
lepa888: folds 
JPJonnes: folds 
celfrieling: folds 
alex150372: folds 
monaco2624: folds 
VodkaForMe: raises 40 to 80
malik_msk: calls 80
HackNga$: calls 60
Abandini: calls 40
*** FLOP *** [5h 7d 4h]
alex150372 has returned
HackNga$: checks 
Abandini: checks 
VodkaForMe: checks 
malik_msk: checks 
*** TURN *** [5h 7d 4h] [7h]
HackNga$: bets 160
Abandini: calls 160
VodkaForMe: folds 
malik_msk: calls 160
*** RIVER *** [5h 7d 4h 7h] [3d]
HackNga$: bets 920
Abandini: calls 920
malik_msk: folds 
*** SHOW DOWN ***
HackNga$: shows [7c Js] (three of a kind, Sevens)
Abandini: mucks hand 
HackNga$ collected 2640 from pot
*** SUMMARY ***
Total pot 2640 | Rake 0 
Board [5h 7d 4h 7h 3d]
Seat 1: Abandini (big blind) mucked [8d 7s]
Seat 2: lepa888 folded before Flop (didn't bet)
Seat 3: JPJonnes folded before Flop (didn't bet)
Seat 4: celfrieling folded before Flop (didn't bet)
Seat 5: alex150372 folded before Flop (didn't bet)
Seat 6: monaco2624 folded before Flop (didn't bet)
Seat 7: VodkaForMe folded on the Turn
Seat 8: malik_msk (button) folded on the River
Seat 9: HackNga$ (small blind) showed [7c Js] and won (2640) with three of a kind, Sevens



PokerStars Game #70062814393: Tournament #545010286, $5.00+$0.50 USD Hold'em No Limit - Level III (20/40) - 2011/11/05 17:25:43 MSK [2011/11/05 9:25:43 ET]
Table '545010286 255' 9-max Seat #9 is the button
Seat 1: Abandini (710 in chips) 
Seat 2: lepa888 (580 in chips) 
Seat 3: JPJonnes (5840 in chips) 
Seat 4: celfrieling (6007 in chips) 
Seat 5: alex150372 (2650 in chips) 
Seat 6: monaco2624 (3765 in chips) 
Seat 7: VodkaForMe (7010 in chips) 
Seat 8: malik_msk (5325 in chips) 
Seat 9: HackNga$ (3800 in chips) 
Abandini: posts small blind 20
lepa888: posts big blind 40
*** HOLE CARDS ***
Dealt to malik_msk [3h Kd]
JPJonnes: folds 
celfrieling: folds 
alex150372: calls 40
monaco2624: folds 
VodkaForMe: raises 80 to 120
malik_msk: folds 
HackNga$: calls 120
Abandini: folds 
lepa888: folds 
alex150372: calls 80
*** FLOP *** [3s 6c Kh]
alex150372: bets 240
VodkaForMe: folds 
HackNga$: calls 240
*** TURN *** [3s 6c Kh] [As]
alex150372: bets 160
HackNga$: raises 390 to 550
alex150372: calls 390
*** RIVER *** [3s 6c Kh As] [Jc]
alex150372: checks 
HackNga$: bets 2890 and is all-in
alex150372: calls 1740 and is all-in
Uncalled bet (1150) returned to HackNga$
*** SHOW DOWN ***
HackNga$: shows [Jd 6d] (two pair, Jacks and Sixes)
alex150372: shows [Qd Kc] (a pair of Kings)
HackNga$ collected 5480 from pot
alex150372 finished the tournament in 2776th place
*** SUMMARY ***
Total pot 5480 | Rake 0 
Board [3s 6c Kh As Jc]
Seat 1: Abandini (small blind) folded before Flop
Seat 2: lepa888 (big blind) folded before Flop
Seat 3: JPJonnes folded before Flop (didn't bet)
Seat 4: celfrieling folded before Flop (didn't bet)
Seat 5: alex150372 showed [Qd Kc] and lost with a pair of Kings
Seat 6: monaco2624 folded before Flop (didn't bet)
Seat 7: VodkaForMe folded on the Flop
Seat 8: malik_msk folded before Flop (didn't bet)
Seat 9: HackNga$ (button) showed [Jd 6d] and won (5480) with two pair, Jacks and Sixes



PokerStars Game #70062873247: Tournament #545010286, $5.00+$0.50 USD Hold'em No Limit - Level III (20/40) - 2011/11/05 17:27:09 MSK [2011/11/05 9:27:09 ET]
Table '545010286 255' 9-max Seat #1 is the button
Seat 1: Abandini (690 in chips) 
Seat 2: lepa888 (540 in chips) 
Seat 3: JPJonnes (5840 in chips) 
Seat 4: celfrieling (6007 in chips) 
Seat 6: monaco2624 (3765 in chips) 
Seat 7: VodkaForMe (6890 in chips) 
Seat 8: malik_msk (5325 in chips) 
Seat 9: HackNga$ (6630 in chips) 
lepa888: posts small blind 20
JPJonnes: posts big blind 40
*** HOLE CARDS ***
Dealt to malik_msk [2s 3c]
celfrieling: folds 
monaco2624: raises 40 to 80
VodkaForMe: folds 
malik_msk: folds 
catblu2 is connected 
monaco2624 said, "zzzzzzzzzzz"
HackNga$ has timed out
HackNga$: folds 
HackNga$ is sitting out
Abandini: folds 
lepa888: folds 
JPJonnes: calls 40
*** FLOP *** [Ts 8s 9c]
JPJonnes: checks 
HackNga$ has returned
monaco2624: bets 80
JPJonnes: calls 80
*** TURN *** [Ts 8s 9c] [6c]
JPJonnes: checks 
monaco2624: bets 240
JPJonnes: calls 240
*** RIVER *** [Ts 8s 9c 6c] [Th]
JPJonnes: checks 
monaco2624: bets 340
JPJonnes: raises 940 to 1280
monaco2624: calls 940
*** SHOW DOWN ***
JPJonnes: shows [4d Td] (three of a kind, Tens)
monaco2624: shows [Qh Jd] (a straight, Eight to Queen)
monaco2624 collected 3380 from pot
*** SUMMARY ***
Total pot 3380 | Rake 0 
Board [Ts 8s 9c 6c Th]
Seat 1: Abandini (button) folded before Flop (didn't bet)
Seat 2: lepa888 (small blind) folded before Flop
Seat 3: JPJonnes (big blind) showed [4d Td] and lost with three of a kind, Tens
Seat 4: celfrieling folded before Flop (didn't bet)
Seat 6: monaco2624 showed [Qh Jd] and won (3380) with a straight, Eight to Queen
Seat 7: VodkaForMe folded before Flop (didn't bet)
Seat 8: malik_msk folded before Flop (didn't bet)
Seat 9: HackNga$ folded before Flop (didn't bet)



PokerStars Game #70062927766: Tournament #545010286, $5.00+$0.50 USD Hold'em No Limit - Level III (20/40) - 2011/11/05 17:28:29 MSK [2011/11/05 9:28:29 ET]
Table '545010286 255' 9-max Seat #2 is the button
Seat 1: Abandini (690 in chips) 
Seat 2: lepa888 (520 in chips) 
Seat 3: JPJonnes (4160 in chips) 
Seat 4: celfrieling (6007 in chips) 
Seat 5: catblu2 (3000 in chips) 
Seat 6: monaco2624 (5465 in chips) 
Seat 7: VodkaForMe (6890 in chips) 
Seat 8: malik_msk (5325 in chips) 
Seat 9: HackNga$ (6630 in chips) 
JPJonnes: posts small blind 20
celfrieling: posts big blind 40
*** HOLE CARDS ***
Dealt to malik_msk [2d 7s]
catblu2: folds 
monaco2624: folds 
VodkaForMe: folds 
malik_msk: folds 
HackNga$: raises 80 to 120
Abandini: raises 570 to 690 and is all-in
lepa888: folds 
JPJonnes: raises 910 to 1600
celfrieling: folds 
HackNga$: raises 5030 to 6630 and is all-in
JPJonnes: calls 2560 and is all-in
Uncalled bet (2470) returned to HackNga$
*** FLOP *** [2c Qs 5d]
*** TURN *** [2c Qs 5d] [5c]
*** RIVER *** [2c Qs 5d 5c] [8d]
*** SHOW DOWN ***
JPJonnes: shows [Jd Ks] (a pair of Fives)
HackNga$: shows [Ad Js] (a pair of Fives - Ace kicker)
HackNga$ collected 6940 from side pot
Abandini: shows [Kc Kh] (two pair, Kings and Fives)
Abandini collected 2110 from main pot
JPJonnes finished the tournament in 2798th place
*** SUMMARY ***
Total pot 9050 Main pot 2110. Side pot 6940. | Rake 0 
Board [2c Qs 5d 5c 8d]
Seat 1: Abandini showed [Kc Kh] and won (2110) with two pair, Kings and Fives
Seat 2: lepa888 (button) folded before Flop (didn't bet)
Seat 3: JPJonnes (small blind) showed [Jd Ks] and lost with a pair of Fives
Seat 4: celfrieling (big blind) folded before Flop
Seat 5: catblu2 folded before Flop (didn't bet)
Seat 6: monaco2624 folded before Flop (didn't bet)
Seat 7: VodkaForMe folded before Flop (didn't bet)
Seat 8: malik_msk folded before Flop (didn't bet)
Seat 9: HackNga$ showed [Ad Js] and won (6940) with a pair of Fives



PokerStars Game #70062966646: Tournament #545010286, $5.00+$0.50 USD Hold'em No Limit - Level III (20/40) - 2011/11/05 17:29:26 MSK [2011/11/05 9:29:26 ET]
Table '545010286 255' 9-max Seat #4 is the button
Seat 1: Abandini (2110 in chips) 
Seat 2: lepa888 (520 in chips) 
Seat 3: fiks7 (3000 in chips) 
Seat 4: celfrieling (5967 in chips) 
Seat 5: catblu2 (3000 in chips) 
Seat 6: monaco2624 (5465 in chips) 
Seat 7: VodkaForMe (6890 in chips) 
Seat 8: malik_msk (5325 in chips) 
Seat 9: HackNga$ (9410 in chips) 
catblu2: posts small blind 20
monaco2624: posts big blind 40
*** HOLE CARDS ***
Dealt to malik_msk [7c 5d]
VodkaForMe: folds 
malik_msk: calls 40
HackNga$: folds 
Abandini: folds 
lepa888: folds 
fiks7: raises 104 to 144
celfrieling: folds 
catblu2: raises 736 to 880
monaco2624: folds 
malik_msk: folds 
fiks7: folds 
Uncalled bet (736) returned to catblu2
catblu2 collected 368 from pot
*** SUMMARY ***
Total pot 368 | Rake 0 
Seat 1: Abandini folded before Flop (didn't bet)
Seat 2: lepa888 folded before Flop (didn't bet)
Seat 3: fiks7 folded before Flop
Seat 4: celfrieling (button) folded before Flop (didn't bet)
Seat 5: catblu2 (small blind) collected (368)
Seat 6: monaco2624 (big blind) folded before Flop
Seat 7: VodkaForMe folded before Flop (didn't bet)
Seat 8: malik_msk folded before Flop
Seat 9: HackNga$ folded before Flop (didn't bet)



PokerStars Game #70062998239: Tournament #545010286, $5.00+$0.50 USD Hold'em No Limit - Level IV (25/50) - 2011/11/05 17:30:11 MSK [2011/11/05 9:30:11 ET]
Table '545010286 255' 9-max Seat #5 is the button
Seat 1: Abandini (2110 in chips) 
Seat 2: lepa888 (520 in chips) 
Seat 3: fiks7 (2856 in chips) 
Seat 4: celfrieling (5967 in chips) 
Seat 5: catblu2 (3224 in chips) 
Seat 6: monaco2624 (5425 in chips) 
Seat 7: VodkaForMe (6890 in chips) 
Seat 8: malik_msk (5285 in chips) 
Seat 9: HackNga$ (9410 in chips) 
monaco2624: posts small blind 25
VodkaForMe: posts big blind 50
*** HOLE CARDS ***
Dealt to malik_msk [6c 5d]
malik_msk: calls 50
HackNga$: raises 200 to 250
Abandini: folds 
lepa888: folds 
fiks7: raises 2606 to 2856 and is all-in
celfrieling: folds 
catblu2: folds 
monaco2624: folds 
VodkaForMe: folds 
malik_msk: folds 
HackNga$: calls 2606
*** FLOP *** [8c 9s 6h]
*** TURN *** [8c 9s 6h] [3c]
*** RIVER *** [8c 9s 6h 3c] [Ac]
*** SHOW DOWN ***
HackNga$: shows [5h 5s] (a pair of Fives)
fiks7: shows [Qs Ad] (a pair of Aces)
fiks7 collected 5837 from pot
*** SUMMARY ***
Total pot 5837 | Rake 0 
Board [8c 9s 6h 3c Ac]
Seat 1: Abandini folded before Flop (didn't bet)
Seat 2: lepa888 folded before Flop (didn't bet)
Seat 3: fiks7 showed [Qs Ad] and won (5837) with a pair of Aces
Seat 4: celfrieling folded before Flop (didn't bet)
Seat 5: catblu2 (button) folded before Flop (didn't bet)
Seat 6: monaco2624 (small blind) folded before Flop
Seat 7: VodkaForMe (big blind) folded before Flop
Seat 8: malik_msk folded before Flop
Seat 9: HackNga$ showed [5h 5s] and lost with a pair of Fives



PokerStars Game #70063020762: Tournament #545010286, $5.00+$0.50 USD Hold'em No Limit - Level IV (25/50) - 2011/11/05 17:30:43 MSK [2011/11/05 9:30:43 ET]
Table '545010286 255' 9-max Seat #6 is the button
Seat 1: Abandini (2110 in chips) 
Seat 2: lepa888 (520 in chips) 
Seat 3: fiks7 (5837 in chips) 
Seat 4: celfrieling (5967 in chips) 
Seat 5: catblu2 (3224 in chips) 
Seat 6: monaco2624 (5400 in chips) 
Seat 7: VodkaForMe (6840 in chips) 
Seat 8: malik_msk (5235 in chips) 
Seat 9: HackNga$ (6554 in chips) 
VodkaForMe: posts small blind 25
malik_msk: posts big blind 50
*** HOLE CARDS ***
Dealt to malik_msk [Ac 3d]
HackNga$: raises 100 to 150
Abandini: folds 
lepa888: folds 
fiks7: folds 
celfrieling has timed out
celfrieling: folds 
celfrieling is sitting out
celfrieling has returned
catblu2: folds 
monaco2624: calls 150
VodkaForMe: folds 
malik_msk: calls 100
*** FLOP *** [Ks Ts 6s]
malik_msk: checks 
HackNga$: bets 250
monaco2624: folds 
malik_msk: folds 
Uncalled bet (250) returned to HackNga$
HackNga$ collected 475 from pot
HackNga$: doesn't show hand 
*** SUMMARY ***
Total pot 475 | Rake 0 
Board [Ks Ts 6s]
Seat 1: Abandini folded before Flop (didn't bet)
Seat 2: lepa888 folded before Flop (didn't bet)
Seat 3: fiks7 folded before Flop (didn't bet)
Seat 4: celfrieling folded before Flop (didn't bet)
Seat 5: catblu2 folded before Flop (didn't bet)
Seat 6: monaco2624 (button) folded on the Flop
Seat 7: VodkaForMe (small blind) folded before Flop
Seat 8: malik_msk (big blind) folded on the Flop
Seat 9: HackNga$ collected (475)



PokerStars Game #70063059103: Tournament #545010286, $5.00+$0.50 USD Hold'em No Limit - Level IV (25/50) - 2011/11/05 17:31:38 MSK [2011/11/05 9:31:38 ET]
Table '545010286 255' 9-max Seat #7 is the button
Seat 1: Abandini (2110 in chips) 
Seat 2: lepa888 (520 in chips) 
Seat 3: fiks7 (5837 in chips) 
Seat 4: celfrieling (5967 in chips) 
Seat 5: catblu2 (3224 in chips) 
Seat 6: monaco2624 (5250 in chips) 
Seat 7: VodkaForMe (6815 in chips) 
Seat 8: malik_msk (5085 in chips) 
Seat 9: HackNga$ (6879 in chips) 
malik_msk: posts small blind 25
HackNga$: posts big blind 50
*** HOLE CARDS ***
Dealt to malik_msk [Qs As]
Abandini: raises 75 to 125
lepa888: folds 
fiks7: calls 125
celfrieling: folds 
catblu2: folds 
monaco2624: calls 125
VodkaForMe: folds 
malik_msk: raises 625 to 750
HackNga$: raises 6129 to 6879 and is all-in
Abandini: calls 1985 and is all-in
fiks7: folds 
monaco2624: folds 
malik_msk: calls 4335 and is all-in
Uncalled bet (1794) returned to HackNga$
*** FLOP *** [Ac Kc 5d]
*** TURN *** [Ac Kc 5d] [3h]
*** RIVER *** [Ac Kc 5d 3h] [4s]
*** SHOW DOWN ***
malik_msk: shows [Qs As] (a pair of Aces)
HackNga$: shows [8c Qc] (high card Ace)
malik_msk collected 5950 from side pot
Abandini: shows [Jh Jc] (a pair of Jacks)
malik_msk collected 6580 from main pot
Abandini finished the tournament in 2835th place
*** SUMMARY ***
Total pot 12530 Main pot 6580. Side pot 5950. | Rake 0 
Board [Ac Kc 5d 3h 4s]
Seat 1: Abandini showed [Jh Jc] and lost with a pair of Jacks
Seat 2: lepa888 folded before Flop (didn't bet)
Seat 3: fiks7 folded before Flop
Seat 4: celfrieling folded before Flop (didn't bet)
Seat 5: catblu2 folded before Flop (didn't bet)
Seat 6: monaco2624 folded before Flop
Seat 7: VodkaForMe (button) folded before Flop (didn't bet)
Seat 8: malik_msk (small blind) showed [Qs As] and won (12530) with a pair of Aces
Seat 9: HackNga$ (big blind) showed [8c Qc] and lost with high card Ace



PokerStars Game #70063088481: Tournament #545010286, $5.00+$0.50 USD Hold'em No Limit - Level IV (25/50) - 2011/11/05 17:32:21 MSK [2011/11/05 9:32:21 ET]
Table '545010286 255' 9-max Seat #8 is the button
Seat 2: lepa888 (520 in chips) 
Seat 3: fiks7 (5712 in chips) 
Seat 4: celfrieling (5967 in chips) 
Seat 5: catblu2 (3224 in chips) 
Seat 6: monaco2624 (5125 in chips) 
Seat 7: VodkaForMe (6815 in chips) 
Seat 8: malik_msk (12530 in chips) 
Seat 9: HackNga$ (1794 in chips) 
HackNga$: posts small blind 25
lepa888: posts big blind 50
*** HOLE CARDS ***
Dealt to malik_msk [3c 6c]
fiks7: calls 50
celfrieling: folds 
catblu2: raises 200 to 250
monaco2624: folds 
VodkaForMe: folds 
malik_msk: folds 
HackNga$: calls 225
lepa888: folds 
fiks7: calls 200
*** FLOP *** [Jh Kc 7c]
HackNga$: checks 
fiks7: checks 
catblu2: checks 
*** TURN *** [Jh Kc 7c] [9h]
HackNga$: checks 
fiks7: checks 
seba16 is connected 
catblu2: bets 450
HackNga$: folds 
fiks7: folds [8c 8s]
Uncalled bet (450) returned to catblu2
catblu2 collected 800 from pot
*** SUMMARY ***
Total pot 800 | Rake 0 
Board [Jh Kc 7c 9h]
Seat 2: lepa888 (big blind) folded before Flop
Seat 3: fiks7 folded on the Turn
Seat 4: celfrieling folded before Flop (didn't bet)
Seat 5: catblu2 collected (800)
Seat 6: monaco2624 folded before Flop (didn't bet)
Seat 7: VodkaForMe folded before Flop (didn't bet)
Seat 8: malik_msk (button) folded before Flop (didn't bet)
Seat 9: HackNga$ (small blind) folded on the Turn



PokerStars Game #70063148692: Tournament #545010286, $5.00+$0.50 USD Hold'em No Limit - Level IV (25/50) - 2011/11/05 17:33:47 MSK [2011/11/05 9:33:47 ET]
Table '545010286 255' 9-max Seat #9 is the button
Seat 1: seba16 (3000 in chips) out of hand (moved from another table into small blind)
Seat 2: lepa888 (470 in chips) 
Seat 3: fiks7 (5462 in chips) 
Seat 4: celfrieling (5967 in chips) 
Seat 5: catblu2 (3774 in chips) 
Seat 6: monaco2624 (5125 in chips) 
Seat 7: VodkaForMe (6815 in chips) 
Seat 8: malik_msk (12530 in chips) 
Seat 9: HackNga$ (1544 in chips) 
lepa888: posts small blind 25
fiks7: posts big blind 50
*** HOLE CARDS ***
Dealt to malik_msk [Kd 2h]
celfrieling: folds 
catblu2: raises 150 to 200
monaco2624: folds 
VodkaForMe: calls 200
malik_msk: folds 
HackNga$: folds 
lepa888: folds 
fiks7: folds 
*** FLOP *** [9h 3d Tc]
catblu2: bets 300
VodkaForMe: folds 
Uncalled bet (300) returned to catblu2
catblu2 collected 475 from pot
*** SUMMARY ***
Total pot 475 | Rake 0 
Board [9h 3d Tc]
Seat 2: lepa888 (small blind) folded before Flop
Seat 3: fiks7 (big blind) folded before Flop
Seat 4: celfrieling folded before Flop (didn't bet)
Seat 5: catblu2 collected (475)
Seat 6: monaco2624 folded before Flop (didn't bet)
Seat 7: VodkaForMe folded on the Flop
Seat 8: malik_msk folded before Flop (didn't bet)
Seat 9: HackNga$ (button) folded before Flop (didn't bet)



PokerStars Game #70063174267: Tournament #545010286, $5.00+$0.50 USD Hold'em No Limit - Level IV (25/50) - 2011/11/05 17:34:24 MSK [2011/11/05 9:34:24 ET]
Table '545010286 255' 9-max Seat #2 is the button
Seat 1: seba16 (3000 in chips) 
Seat 2: lepa888 (445 in chips) 
Seat 3: fiks7 (5412 in chips) 
Seat 4: celfrieling (5967 in chips) 
Seat 5: catblu2 (4049 in chips) 
Seat 6: monaco2624 (5125 in chips) 
Seat 7: VodkaForMe (6615 in chips) 
Seat 8: malik_msk (12530 in chips) 
Seat 9: HackNga$ (1544 in chips) 
fiks7: posts small blind 25
celfrieling: posts big blind 50
*** HOLE CARDS ***
Dealt to malik_msk [9s 4d]
catblu2: folds 
monaco2624: raises 50 to 100
VodkaForMe: folds 
malik_msk: folds 
HackNga$: folds 
seba16: calls 100
lepa888: folds 
fiks7: raises 288 to 388
celfrieling: folds 
monaco2624: folds 
seba16: calls 288
*** FLOP *** [7c 5h 7s]
fiks7: checks 
seba16: bets 300
fiks7: calls 300
*** TURN *** [7c 5h 7s] [Qd]
fiks7: bets 777
seba16: calls 777
*** RIVER *** [7c 5h 7s Qd] [7d]
fiks7: bets 1099
seba16: calls 1099
*** SHOW DOWN ***
fiks7: shows [Ad Ah] (a full house, Sevens full of Aces)
seba16: mucks hand 
fiks7 collected 5278 from pot
*** SUMMARY ***
Total pot 5278 | Rake 0 
Board [7c 5h 7s Qd 7d]
Seat 1: seba16 mucked [9c 9d]
Seat 2: lepa888 (button) folded before Flop (didn't bet)
Seat 3: fiks7 (small blind) showed [Ad Ah] and won (5278) with a full house, Sevens full of Aces
Seat 4: celfrieling (big blind) folded before Flop
Seat 5: catblu2 folded before Flop (didn't bet)
Seat 6: monaco2624 folded before Flop
Seat 7: VodkaForMe folded before Flop (didn't bet)
Seat 8: malik_msk folded before Flop (didn't bet)
Seat 9: HackNga$ folded before Flop (didn't bet)



PokerStars Game #70063258098: Tournament #545010286, $5.00+$0.50 USD Hold'em No Limit - Level IV (25/50) - 2011/11/05 17:36:25 MSK [2011/11/05 9:36:25 ET]
Table '545010286 255' 9-max Seat #3 is the button
Seat 1: seba16 (436 in chips) 
Seat 2: lepa888 (445 in chips) 
Seat 3: fiks7 (8126 in chips) 
Seat 4: celfrieling (5917 in chips) 
Seat 5: catblu2 (4049 in chips) 
Seat 6: monaco2624 (5025 in chips) 
Seat 7: VodkaForMe (6615 in chips) 
Seat 8: malik_msk (12530 in chips) 
Seat 9: HackNga$ (1544 in chips) 
celfrieling: posts small blind 25
catblu2: posts big blind 50
*** HOLE CARDS ***
Dealt to malik_msk [Kc Td]
monaco2624: folds 
malik_msk said, "nh"
fiks7 said, "aga"
VodkaForMe: folds 
malik_msk: calls 50
HackNga$: folds 
seba16: folds 
lepa888: folds 
fiks7: folds 
celfrieling: folds 
catblu2: checks 
*** FLOP *** [Jh Ac Kd]
catblu2: checks 
malik_msk: bets 62
catblu2: calls 62
*** TURN *** [Jh Ac Kd] [8d]
catblu2: checks 
malik_msk: bets 74
catblu2: calls 74
*** RIVER *** [Jh Ac Kd 8d] [2s]
catblu2: bets 300
malik_msk: calls 300
*** SHOW DOWN ***
catblu2: shows [3h Qd] (high card Ace)
malik_msk: shows [Kc Td] (a pair of Kings)
malik_msk collected 997 from pot
*** SUMMARY ***
Total pot 997 | Rake 0 
Board [Jh Ac Kd 8d 2s]
Seat 1: seba16 folded before Flop (didn't bet)
Seat 2: lepa888 folded before Flop (didn't bet)
Seat 3: fiks7 (button) folded before Flop (didn't bet)
Seat 4: celfrieling (small blind) folded before Flop
Seat 5: catblu2 (big blind) showed [3h Qd] and lost with high card Ace
Seat 6: monaco2624 folded before Flop (didn't bet)
Seat 7: VodkaForMe folded before Flop (didn't bet)
Seat 8: malik_msk showed [Kc Td] and won (997) with a pair of Kings
Seat 9: HackNga$ folded before Flop (didn't bet)



PokerStars Game #70063304677: Tournament #545010286, $5.00+$0.50 USD Hold'em No Limit - Level IV (25/50) - 2011/11/05 17:37:33 MSK [2011/11/05 9:37:33 ET]
Table '545010286 255' 9-max Seat #4 is the button
Seat 1: seba16 (436 in chips) 
Seat 2: lepa888 (445 in chips) 
Seat 3: fiks7 (8126 in chips) 
Seat 4: celfrieling (5892 in chips) 
Seat 5: catblu2 (3563 in chips) 
Seat 6: monaco2624 (5025 in chips) 
Seat 7: VodkaForMe (6615 in chips) 
Seat 8: malik_msk (13041 in chips) 
Seat 9: HackNga$ (1544 in chips) 
catblu2: posts small blind 25
monaco2624: posts big blind 50
*** HOLE CARDS ***
Dealt to malik_msk [Th As]
VodkaForMe: folds 
malik_msk: calls 50
HackNga$: folds 
seba16: folds 
lepa888: folds 
fiks7: folds 
celfrieling: folds 
catblu2: calls 25
monaco2624: checks 
*** FLOP *** [Kh 9c 6c]
catblu2: checks 
monaco2624: checks 
malik_msk: checks 
*** TURN *** [Kh 9c 6c] [6d]
catblu2: bets 100
monaco2624: folds 
malik_msk: folds 
Uncalled bet (100) returned to catblu2
catblu2 collected 150 from pot
*** SUMMARY ***
Total pot 150 | Rake 0 
Board [Kh 9c 6c 6d]
Seat 1: seba16 folded before Flop (didn't bet)
Seat 2: lepa888 folded before Flop (didn't bet)
Seat 3: fiks7 folded before Flop (didn't bet)
Seat 4: celfrieling (button) folded before Flop (didn't bet)
Seat 5: catblu2 (small blind) collected (150)
Seat 6: monaco2624 (big blind) folded on the Turn
Seat 7: VodkaForMe folded before Flop (didn't bet)
Seat 8: malik_msk folded on the Turn
Seat 9: HackNga$ folded before Flop (didn't bet)



PokerStars Game #70063330151: Tournament #545010286, $5.00+$0.50 USD Hold'em No Limit - Level IV (25/50) - 2011/11/05 17:38:10 MSK [2011/11/05 9:38:10 ET]
Table '545010286 255' 9-max Seat #5 is the button
Seat 1: seba16 (436 in chips) 
Seat 2: lepa888 (445 in chips) 
Seat 3: fiks7 (8126 in chips) 
Seat 4: celfrieling (5892 in chips) 
Seat 5: catblu2 (3663 in chips) 
Seat 6: monaco2624 (4975 in chips) 
Seat 7: VodkaForMe (6615 in chips) 
Seat 8: malik_msk (12991 in chips) 
Seat 9: HackNga$ (1544 in chips) 
monaco2624: posts small blind 25
VodkaForMe: posts big blind 50
*** HOLE CARDS ***
Dealt to malik_msk [3d Kd]
malik_msk: folds 
HackNga$: raises 100 to 150
seba16: raises 286 to 436 and is all-in
lepa888: folds 
fiks7: folds 
celfrieling: folds 
catblu2: folds 
monaco2624: folds 
VodkaForMe: folds 
HackNga$: calls 286
*** FLOP *** [8h 4s 6s]
*** TURN *** [8h 4s 6s] [8d]
*** RIVER *** [8h 4s 6s 8d] [Js]
*** SHOW DOWN ***
HackNga$: shows [2s Ah] (a pair of Eights)
seba16: shows [6h 6d] (a full house, Sixes full of Eights)
seba16 collected 947 from pot
*** SUMMARY ***
Total pot 947 | Rake 0 
Board [8h 4s 6s 8d Js]
Seat 1: seba16 showed [6h 6d] and won (947) with a full house, Sixes full of Eights
Seat 2: lepa888 folded before Flop (didn't bet)
Seat 3: fiks7 folded before Flop (didn't bet)
Seat 4: celfrieling folded before Flop (didn't bet)
Seat 5: catblu2 (button) folded before Flop (didn't bet)
Seat 6: monaco2624 (small blind) folded before Flop
Seat 7: VodkaForMe (big blind) folded before Flop
Seat 8: malik_msk folded before Flop (didn't bet)
Seat 9: HackNga$ showed [2s Ah] and lost with a pair of Eights



PokerStars Game #70063350420: Tournament #545010286, $5.00+$0.50 USD Hold'em No Limit - Level IV (25/50) - 2011/11/05 17:38:39 MSK [2011/11/05 9:38:39 ET]
Table '545010286 255' 9-max Seat #6 is the button
Seat 1: seba16 (947 in chips) 
Seat 2: lepa888 (445 in chips) 
Seat 3: fiks7 (8126 in chips) 
Seat 4: celfrieling (5892 in chips) 
Seat 5: catblu2 (3663 in chips) 
Seat 6: monaco2624 (4950 in chips) 
Seat 7: VodkaForMe (6565 in chips) 
Seat 8: malik_msk (12991 in chips) 
Seat 9: HackNga$ (1108 in chips) 
VodkaForMe: posts small blind 25
malik_msk: posts big blind 50
*** HOLE CARDS ***
Dealt to malik_msk [5h 6h]
HackNga$: folds 
seba16: raises 897 to 947 and is all-in
lepa888: folds 
fiks7: folds 
celfrieling: folds 
catblu2: calls 947
monaco2624: folds 
VodkaForMe: folds 
malik_msk: calls 897
*** FLOP *** [Qh Kh Ah]
malik_msk: checks 
catblu2: checks 
*** TURN *** [Qh Kh Ah] [Tc]
malik_msk: checks 
catblu2: checks 
*** RIVER *** [Qh Kh Ah Tc] [9s]
malik_msk: bets 900
catblu2: calls 900
*** SHOW DOWN ***
malik_msk: shows [5h 6h] (a flush, Ace high)
catblu2: mucks hand 
malik_msk collected 1800 from side pot
seba16: mucks hand 
malik_msk collected 2866 from main pot
seba16 finished the tournament in 2854th place
*** SUMMARY ***
Total pot 4666 Main pot 2866. Side pot 1800. | Rake 0 
Board [Qh Kh Ah Tc 9s]
Seat 1: seba16 mucked [4d 4h]
Seat 2: lepa888 folded before Flop (didn't bet)
Seat 3: fiks7 folded before Flop (didn't bet)
Seat 4: celfrieling folded before Flop (didn't bet)
Seat 5: catblu2 mucked [Jc Qs]
Seat 6: monaco2624 (button) folded before Flop (didn't bet)
Seat 7: VodkaForMe (small blind) folded before Flop
Seat 8: malik_msk (big blind) showed [5h 6h] and won (4666) with a flush, Ace high
Seat 9: HackNga$ folded before Flop (didn't bet)



PokerStars Game #70063389144: Tournament #545010286, $5.00+$0.50 USD Hold'em No Limit - Level IV (25/50) - 2011/11/05 17:39:36 MSK [2011/11/05 9:39:36 ET]
Table '545010286 255' 9-max Seat #7 is the button
Seat 2: lepa888 (445 in chips) 
Seat 3: fiks7 (8126 in chips) 
Seat 4: celfrieling (5892 in chips) 
Seat 5: catblu2 (1816 in chips) 
Seat 6: monaco2624 (4950 in chips) 
Seat 7: VodkaForMe (6540 in chips) 
Seat 8: malik_msk (15810 in chips) 
Seat 9: HackNga$ (1108 in chips) 
malik_msk: posts small blind 25
HackNga$: posts big blind 50
*** HOLE CARDS ***
Dealt to malik_msk [5c 8d]
fiks7 said, "mdaaa"
lepa888: calls 50
fiks7: calls 50
timbermendes is connected 
celfrieling: folds 
catblu2: folds 
monaco2624: folds 
VodkaForMe: raises 200 to 250
malik_msk: folds 
HackNga$: folds 
lepa888: raises 195 to 445 and is all-in
fiks7: folds 
VodkaForMe: calls 195
malik_msk said, "zamanival do rivera"
*** FLOP *** [Kh Tc 4h]
*** TURN *** [Kh Tc 4h] [9s]
*** RIVER *** [Kh Tc 4h 9s] [Qh]
*** SHOW DOWN ***
lepa888: shows [Td Kd] (two pair, Kings and Tens)
VodkaForMe: shows [As Jh] (a straight, Ten to Ace)
VodkaForMe collected 1015 from pot
lepa888 finished the tournament in 2860th place
monaco2624 said, "nice"
*** SUMMARY ***
Total pot 1015 | Rake 0 
Board [Kh Tc 4h 9s Qh]
Seat 2: lepa888 showed [Td Kd] and lost with two pair, Kings and Tens
Seat 3: fiks7 folded before Flop
Seat 4: celfrieling folded before Flop (didn't bet)
Seat 5: catblu2 folded before Flop (didn't bet)
Seat 6: monaco2624 folded before Flop (didn't bet)
Seat 7: VodkaForMe (button) showed [As Jh] and won (1015) with a straight, Ten to Ace
Seat 8: malik_msk (small blind) folded before Flop
Seat 9: HackNga$ (big blind) folded before Flop



PokerStars Game #70063425895: Tournament #545010286, $5.00+$0.50 USD Hold'em No Limit - Level V (30/60) - 2011/11/05 17:40:30 MSK [2011/11/05 9:40:30 ET]
Table '545010286 255' 9-max Seat #8 is the button
Seat 1: timbermendes (3000 in chips) 
Seat 2: phong514 (3000 in chips) 
Seat 3: fiks7 (8076 in chips) 
Seat 4: celfrieling (5892 in chips) 
Seat 5: catblu2 (1816 in chips) 
Seat 6: monaco2624 (4950 in chips) 
Seat 7: VodkaForMe (7110 in chips) 
Seat 8: malik_msk (15785 in chips) 
Seat 9: HackNga$ (1058 in chips) 
timbermendes: posts the ante 5
phong514: posts the ante 5
fiks7: posts the ante 5
celfrieling: posts the ante 5
catblu2: posts the ante 5
monaco2624: posts the ante 5
VodkaForMe: posts the ante 5
malik_msk: posts the ante 5
HackNga$: posts the ante 5
HackNga$: posts small blind 30
timbermendes: posts big blind 60
*** HOLE CARDS ***
Dealt to malik_msk [5c Kh]
phong514: calls 60
fiks7: folds 
celfrieling: folds 
catblu2: folds 
monaco2624: folds 
VodkaForMe: folds 
malik_msk: folds 
HackNga$: calls 30
timbermendes: checks 
*** FLOP *** [Kc 4h 7s]
VodkaForMe said, "very nice"
HackNga$: checks 
timbermendes: checks 
phong514: bets 180
HackNga$: folds 
timbermendes: folds 
Uncalled bet (180) returned to phong514
phong514 collected 225 from pot
*** SUMMARY ***
Total pot 225 | Rake 0 
Board [Kc 4h 7s]
Seat 1: timbermendes (big blind) folded on the Flop
Seat 2: phong514 collected (225)
Seat 3: fiks7 folded before Flop (didn't bet)
Seat 4: celfrieling folded before Flop (didn't bet)
Seat 5: catblu2 folded before Flop (didn't bet)
Seat 6: monaco2624 folded before Flop (didn't bet)
Seat 7: VodkaForMe folded before Flop (didn't bet)
Seat 8: malik_msk (button) folded before Flop (didn't bet)
Seat 9: HackNga$ (small blind) folded on the Flop



PokerStars Game #70063451284: Tournament #545010286, $5.00+$0.50 USD Hold'em No Limit - Level V (30/60) - 2011/11/05 17:41:07 MSK [2011/11/05 9:41:07 ET]
Table '545010286 255' 9-max Seat #9 is the button
Seat 1: timbermendes (2935 in chips) 
Seat 2: phong514 (3160 in chips) 
Seat 3: fiks7 (8071 in chips) 
Seat 4: celfrieling (5887 in chips) 
Seat 5: catblu2 (1811 in chips) 
Seat 6: monaco2624 (4945 in chips) 
Seat 7: VodkaForMe (7105 in chips) 
Seat 8: malik_msk (15780 in chips) 
Seat 9: HackNga$ (993 in chips) 
timbermendes: posts the ante 5
phong514: posts the ante 5
fiks7: posts the ante 5
celfrieling: posts the ante 5
catblu2: posts the ante 5
monaco2624: posts the ante 5
VodkaForMe: posts the ante 5
malik_msk: posts the ante 5
HackNga$: posts the ante 5
timbermendes: posts small blind 30
phong514: posts big blind 60
*** HOLE CARDS ***
Dealt to malik_msk [9h 6d]
fiks7: folds 
celfrieling: folds 
catblu2: folds 
monaco2624: folds 
VodkaForMe: raises 60 to 120
malik_msk: folds 
HackNga$: raises 868 to 988 and is all-in
timbermendes: folds 
phong514: folds 
VodkaForMe: folds 
Uncalled bet (868) returned to HackNga$
HackNga$ collected 375 from pot
HackNga$: doesn't show hand 
*** SUMMARY ***
Total pot 375 | Rake 0 
Seat 1: timbermendes (small blind) folded before Flop
Seat 2: phong514 (big blind) folded before Flop
Seat 3: fiks7 folded before Flop (didn't bet)
Seat 4: celfrieling folded before Flop (didn't bet)
Seat 5: catblu2 folded before Flop (didn't bet)
Seat 6: monaco2624 folded before Flop (didn't bet)
Seat 7: VodkaForMe folded before Flop
Seat 8: malik_msk folded before Flop (didn't bet)
Seat 9: HackNga$ (button) collected (375)



PokerStars Game #70063486365: Tournament #545010286, $5.00+$0.50 USD Hold'em No Limit - Level V (30/60) - 2011/11/05 17:41:58 MSK [2011/11/05 9:41:58 ET]
Table '545010286 255' 9-max Seat #1 is the button
Seat 1: timbermendes (2900 in chips) 
Seat 2: phong514 (3095 in chips) 
Seat 3: fiks7 (8066 in chips) 
Seat 4: celfrieling (5882 in chips) 
Seat 5: catblu2 (1806 in chips) 
Seat 6: monaco2624 (4940 in chips) 
Seat 7: VodkaForMe (6980 in chips) 
Seat 8: malik_msk (15775 in chips) 
Seat 9: HackNga$ (1243 in chips) 
timbermendes: posts the ante 5
phong514: posts the ante 5
fiks7: posts the ante 5
celfrieling: posts the ante 5
catblu2: posts the ante 5
monaco2624: posts the ante 5
VodkaForMe: posts the ante 5
malik_msk: posts the ante 5
HackNga$: posts the ante 5
phong514: posts small blind 30
fiks7: posts big blind 60
*** HOLE CARDS ***
Dealt to malik_msk [2d Th]
celfrieling: folds 
catblu2: folds 
monaco2624: folds 
VodkaForMe: folds 
malik_msk: folds 
HackNga$: folds 
timbermendes: folds 
phong514: raises 60 to 120
fiks7: folds 
Uncalled bet (60) returned to phong514
phong514 collected 165 from pot
*** SUMMARY ***
Total pot 165 | Rake 0 
Seat 1: timbermendes (button) folded before Flop (didn't bet)
Seat 2: phong514 (small blind) collected (165)
Seat 3: fiks7 (big blind) folded before Flop
Seat 4: celfrieling folded before Flop (didn't bet)
Seat 5: catblu2 folded before Flop (didn't bet)
Seat 6: monaco2624 folded before Flop (didn't bet)
Seat 7: VodkaForMe folded before Flop (didn't bet)
Seat 8: malik_msk folded before Flop (didn't bet)
Seat 9: HackNga$ folded before Flop (didn't bet)



PokerStars Game #70063510360: Tournament #545010286, $5.00+$0.50 USD Hold'em No Limit - Level V (30/60) - 2011/11/05 17:42:33 MSK [2011/11/05 9:42:33 ET]
Table '545010286 255' 9-max Seat #2 is the button
Seat 1: timbermendes (2895 in chips) 
Seat 2: phong514 (3195 in chips) 
Seat 3: fiks7 (8001 in chips) 
Seat 4: celfrieling (5877 in chips) 
Seat 5: catblu2 (1801 in chips) 
Seat 6: monaco2624 (4935 in chips) 
Seat 7: VodkaForMe (6975 in chips) 
Seat 8: malik_msk (15770 in chips) 
Seat 9: HackNga$ (1238 in chips) 
timbermendes: posts the ante 5
phong514: posts the ante 5
fiks7: posts the ante 5
celfrieling: posts the ante 5
catblu2: posts the ante 5
monaco2624: posts the ante 5
VodkaForMe: posts the ante 5
malik_msk: posts the ante 5
HackNga$: posts the ante 5
fiks7: posts small blind 30
celfrieling: posts big blind 60
*** HOLE CARDS ***
Dealt to malik_msk [Ks 4h]
catblu2: folds 
monaco2624: folds 
VodkaForMe: folds 
malik_msk: folds 
HackNga$: folds 
timbermendes: raises 60 to 120
phong514: folds 
fiks7: calls 90
celfrieling: folds 
*** FLOP *** [Qc Tc 2d]
fiks7: checks 
timbermendes: checks 
*** TURN *** [Qc Tc 2d] [6s]
fiks7: bets 222
timbermendes: folds 
Uncalled bet (222) returned to fiks7
fiks7 collected 345 from pot
*** SUMMARY ***
Total pot 345 | Rake 0 
Board [Qc Tc 2d 6s]
Seat 1: timbermendes folded on the Turn
Seat 2: phong514 (button) folded before Flop (didn't bet)
Seat 3: fiks7 (small blind) collected (345)
Seat 4: celfrieling (big blind) folded before Flop
Seat 5: catblu2 folded before Flop (didn't bet)
Seat 6: monaco2624 folded before Flop (didn't bet)
Seat 7: VodkaForMe folded before Flop (didn't bet)
Seat 8: malik_msk folded before Flop (didn't bet)
Seat 9: HackNga$ folded before Flop (didn't bet)



PokerStars Game #70063553723: Tournament #545010286, $5.00+$0.50 USD Hold'em No Limit - Level V (30/60) - 2011/11/05 17:43:36 MSK [2011/11/05 9:43:36 ET]
Table '545010286 255' 9-max Seat #3 is the button
Seat 1: timbermendes (2770 in chips) 
Seat 2: phong514 (3190 in chips) 
Seat 3: fiks7 (8221 in chips) 
Seat 4: celfrieling (5812 in chips) 
Seat 5: catblu2 (1796 in chips) 
Seat 6: monaco2624 (4930 in chips) 
Seat 7: VodkaForMe (6970 in chips) 
Seat 8: malik_msk (15765 in chips) 
Seat 9: HackNga$ (1233 in chips) 
timbermendes: posts the ante 5
phong514: posts the ante 5
fiks7: posts the ante 5
celfrieling: posts the ante 5
catblu2: posts the ante 5
monaco2624: posts the ante 5
VodkaForMe: posts the ante 5
malik_msk: posts the ante 5
HackNga$: posts the ante 5
celfrieling: posts small blind 30
catblu2: posts big blind 60
*** HOLE CARDS ***
Dealt to malik_msk [2d 4c]
monaco2624: folds 
VodkaForMe: folds 
malik_msk: calls 60
HackNga$: raises 1168 to 1228 and is all-in
timbermendes: folds 
phong514: folds 
fiks7: folds 
celfrieling: folds 
catblu2: folds 
malik_msk: folds 
Uncalled bet (1168) returned to HackNga$
HackNga$ collected 255 from pot
HackNga$: doesn't show hand 
*** SUMMARY ***
Total pot 255 | Rake 0 
Seat 1: timbermendes folded before Flop (didn't bet)
Seat 2: phong514 folded before Flop (didn't bet)
Seat 3: fiks7 (button) folded before Flop (didn't bet)
Seat 4: celfrieling (small blind) folded before Flop
Seat 5: catblu2 (big blind) folded before Flop
Seat 6: monaco2624 folded before Flop (didn't bet)
Seat 7: VodkaForMe folded before Flop (didn't bet)
Seat 8: malik_msk folded before Flop
Seat 9: HackNga$ collected (255)



PokerStars Game #70063578068: Tournament #545010286, $5.00+$0.50 USD Hold'em No Limit - Level V (30/60) - 2011/11/05 17:44:11 MSK [2011/11/05 9:44:11 ET]
Table '545010286 255' 9-max Seat #4 is the button
Seat 1: timbermendes (2765 in chips) 
Seat 2: phong514 (3185 in chips) 
Seat 3: fiks7 (8216 in chips) 
Seat 4: celfrieling (5777 in chips) 
Seat 5: catblu2 (1731 in chips) 
Seat 6: monaco2624 (4925 in chips) 
Seat 7: VodkaForMe (6965 in chips) 
Seat 8: malik_msk (15700 in chips) 
Seat 9: HackNga$ (1423 in chips) 
timbermendes: posts the ante 5
phong514: posts the ante 5
fiks7: posts the ante 5
celfrieling: posts the ante 5
catblu2: posts the ante 5
monaco2624: posts the ante 5
VodkaForMe: posts the ante 5
malik_msk: posts the ante 5
HackNga$: posts the ante 5
catblu2: posts small blind 30
monaco2624: posts big blind 60
*** HOLE CARDS ***
Dealt to malik_msk [4d Qs]
VodkaForMe: folds 
malik_msk: folds 
HackNga$: folds 
timbermendes: folds 
phong514: folds 
fiks7: folds 
celfrieling: raises 195 to 255
catblu2: folds 
monaco2624: folds 
Uncalled bet (195) returned to celfrieling
celfrieling collected 195 from pot
*** SUMMARY ***
Total pot 195 | Rake 0 
Seat 1: timbermendes folded before Flop (didn't bet)
Seat 2: phong514 folded before Flop (didn't bet)
Seat 3: fiks7 folded before Flop (didn't bet)
Seat 4: celfrieling (button) collected (195)
Seat 5: catblu2 (small blind) folded before Flop
Seat 6: monaco2624 (big blind) folded before Flop
Seat 7: VodkaForMe folded before Flop (didn't bet)
Seat 8: malik_msk folded before Flop (didn't bet)
Seat 9: HackNga$ folded before Flop (didn't bet)



PokerStars Game #70063623076: Tournament #545010286, $5.00+$0.50 USD Hold'em No Limit - Level V (30/60) - 2011/11/05 17:45:17 MSK [2011/11/05 9:45:17 ET]
Table '545010286 255' 9-max Seat #5 is the button
Seat 1: timbermendes (2760 in chips) 
Seat 2: phong514 (3180 in chips) 
Seat 3: fiks7 (8211 in chips) 
Seat 4: celfrieling (5907 in chips) 
Seat 5: catblu2 (1696 in chips) 
Seat 6: monaco2624 (4860 in chips) 
Seat 7: VodkaForMe (6960 in chips) 
Seat 8: malik_msk (15695 in chips) 
Seat 9: HackNga$ (1418 in chips) 
timbermendes: posts the ante 5
phong514: posts the ante 5
fiks7: posts the ante 5
celfrieling: posts the ante 5
catblu2: posts the ante 5
monaco2624: posts the ante 5
VodkaForMe: posts the ante 5
malik_msk: posts the ante 5
HackNga$: posts the ante 5
monaco2624: posts small blind 30
VodkaForMe: posts big blind 60
*** HOLE CARDS ***
Dealt to malik_msk [6d Th]
malik_msk: folds 
HackNga$: raises 1353 to 1413 and is all-in
timbermendes: calls 1413
phong514: folds 
fiks7: folds 
celfrieling: folds 
catblu2: folds 
monaco2624: folds 
VodkaForMe: folds 
*** FLOP *** [5h 7h Jh]
*** TURN *** [5h 7h Jh] [Js]
*** RIVER *** [5h 7h Jh Js] [Ah]
*** SHOW DOWN ***
HackNga$: shows [Ad Ks] (two pair, Aces and Jacks)
timbermendes: shows [9d Jd] (three of a kind, Jacks)
timbermendes collected 2961 from pot
HackNga$ finished the tournament in 2862nd place
*** SUMMARY ***
Total pot 2961 | Rake 0 
Board [5h 7h Jh Js Ah]
Seat 1: timbermendes showed [9d Jd] and won (2961) with three of a kind, Jacks
Seat 2: phong514 folded before Flop (didn't bet)
Seat 3: fiks7 folded before Flop (didn't bet)
Seat 4: celfrieling folded before Flop (didn't bet)
Seat 5: catblu2 (button) folded before Flop (didn't bet)
Seat 6: monaco2624 (small blind) folded before Flop
Seat 7: VodkaForMe (big blind) folded before Flop
Seat 8: malik_msk folded before Flop (didn't bet)
Seat 9: HackNga$ showed [Ad Ks] and lost with two pair, Aces and Jacks



PokerStars Game #70063644396: Tournament #545010286, $5.00+$0.50 USD Hold'em No Limit - Level V (30/60) - 2011/11/05 17:45:48 MSK [2011/11/05 9:45:48 ET]
Table '545010286 255' 9-max Seat #6 is the button
Seat 1: timbermendes (4303 in chips) 
Seat 2: phong514 (3175 in chips) 
Seat 3: fiks7 (8206 in chips) 
Seat 4: celfrieling (5902 in chips) 
Seat 5: catblu2 (1691 in chips) 
Seat 6: monaco2624 (4825 in chips) 
Seat 7: VodkaForMe (6895 in chips) 
Seat 8: malik_msk (15690 in chips) 
timbermendes: posts the ante 5
phong514: posts the ante 5
fiks7: posts the ante 5
celfrieling: posts the ante 5
catblu2: posts the ante 5
monaco2624: posts the ante 5
VodkaForMe: posts the ante 5
malik_msk: posts the ante 5
VodkaForMe: posts small blind 30
malik_msk: posts big blind 60
*** HOLE CARDS ***
Dealt to malik_msk [Th 5h]
timbermendes: calls 60
phong514: calls 60
fiks7: folds 
celfrieling: folds 
catblu2: calls 60
monaco2624: calls 60
VodkaForMe: calls 30
malik_msk: checks 
*** FLOP *** [Ts Jc Td]
Kühne1984 is connected 
VodkaForMe: bets 180
malik_msk: raises 180 to 360
timbermendes: folds 
phong514: folds 
catblu2: folds 
monaco2624: raises 4400 to 4760 and is all-in
VodkaForMe: folds 
malik_msk: folds 
Uncalled bet (4400) returned to monaco2624
monaco2624 collected 1300 from pot
monaco2624: doesn't show hand 
*** SUMMARY ***
Total pot 1300 | Rake 0 
Board [Ts Jc Td]
Seat 1: timbermendes folded on the Flop
Seat 2: phong514 folded on the Flop
Seat 3: fiks7 folded before Flop (didn't bet)
Seat 4: celfrieling folded before Flop (didn't bet)
Seat 5: catblu2 folded on the Flop
Seat 6: monaco2624 (button) collected (1300)
Seat 7: VodkaForMe (small blind) folded on the Flop
Seat 8: malik_msk (big blind) folded on the Flop



PokerStars Game #70063703638: Tournament #545010286, $5.00+$0.50 USD Hold'em No Limit - Level V (30/60) - 2011/11/05 17:47:14 MSK [2011/11/05 9:47:14 ET]
Table '545010286 255' 9-max Seat #7 is the button
Seat 1: timbermendes (4238 in chips) 
Seat 2: phong514 (3110 in chips) 
Seat 3: fiks7 (8201 in chips) 
Seat 4: celfrieling (5897 in chips) 
Seat 5: catblu2 (1626 in chips) 
Seat 6: monaco2624 (5700 in chips) 
Seat 7: VodkaForMe (6650 in chips) 
Seat 8: malik_msk (15265 in chips) 
Seat 9: Kühne1984 (3000 in chips) 
timbermendes: posts the ante 5
phong514: posts the ante 5
fiks7: posts the ante 5
celfrieling: posts the ante 5
catblu2: posts the ante 5
monaco2624: posts the ante 5
VodkaForMe: posts the ante 5
malik_msk: posts the ante 5
Kühne1984: posts the ante 5
malik_msk: posts small blind 30
Kühne1984: posts big blind 60
*** HOLE CARDS ***
Dealt to malik_msk [8c 8h]
malik_msk said, "you had bigger kicker I guess"
timbermendes: calls 60
phong514: folds 
fiks7: calls 60
celfrieling: folds 
catblu2: calls 60
monaco2624: calls 60
VodkaForMe: folds 
malik_msk: raises 240 to 300
catblu2 said, "shutup donkey"
Kühne1984: folds 
timbermendes: calls 240
fiks7: folds 
catblu2: calls 240
monaco2624: folds 
*** FLOP *** [Kd Qh 3c]
malik_msk: bets 360
timbermendes: folds 
catblu2: folds 
Uncalled bet (360) returned to malik_msk
malik_msk collected 1125 from pot
malik_msk: doesn't show hand 
*** SUMMARY ***
Total pot 1125 | Rake 0 
Board [Kd Qh 3c]
Seat 1: timbermendes folded on the Flop
Seat 2: phong514 folded before Flop (didn't bet)
Seat 3: fiks7 folded before Flop
Seat 4: celfrieling folded before Flop (didn't bet)
Seat 5: catblu2 folded on the Flop
Seat 6: monaco2624 folded before Flop
Seat 7: VodkaForMe (button) folded before Flop (didn't bet)
Seat 8: malik_msk (small blind) collected (1125)
Seat 9: Kühne1984 (big blind) folded before Flop



PokerStars Game #70063739736: Tournament #545010286, $5.00+$0.50 USD Hold'em No Limit - Level V (30/60) - 2011/11/05 17:48:07 MSK [2011/11/05 9:48:07 ET]
Table '545010286 255' 9-max Seat #8 is the button
Seat 1: timbermendes (3933 in chips) 
Seat 2: phong514 (3105 in chips) 
Seat 3: fiks7 (8136 in chips) 
Seat 4: celfrieling (5892 in chips) 
Seat 5: catblu2 (1321 in chips) 
Seat 6: monaco2624 (5635 in chips) 
Seat 7: VodkaForMe (6645 in chips) 
Seat 8: malik_msk (16085 in chips) 
Seat 9: Kühne1984 (2935 in chips) 
timbermendes: posts the ante 5
phong514: posts the ante 5
fiks7: posts the ante 5
celfrieling: posts the ante 5
catblu2: posts the ante 5
monaco2624: posts the ante 5
VodkaForMe: posts the ante 5
malik_msk: posts the ante 5
Kühne1984: posts the ante 5
Kühne1984: posts small blind 30
timbermendes: posts big blind 60
*** HOLE CARDS ***
Dealt to malik_msk [2s Kc]
phong514: folds 
fiks7: raises 128 to 188
celfrieling: folds 
catblu2: folds 
monaco2624: folds 
VodkaForMe: folds 
malik_msk: folds 
Kühne1984: calls 158
timbermendes: calls 128
*** FLOP *** [Ac 8d 8h]
Kühne1984: checks 
timbermendes: checks 
fiks7: checks 
*** TURN *** [Ac 8d 8h] [9c]
Kühne1984: checks 
timbermendes: checks 
fiks7: bets 222
Kühne1984: calls 222
timbermendes: folds 
*** RIVER *** [Ac 8d 8h 9c] [3c]
Kühne1984: checks 
fiks7: bets 699
Kühne1984: folds 
Uncalled bet (699) returned to fiks7
fiks7 collected 1053 from pot
fiks7: shows [8c 8s] (four of a kind, Eights)
*** SUMMARY ***
Total pot 1053 | Rake 0 
Board [Ac 8d 8h 9c 3c]
Seat 1: timbermendes (big blind) folded on the Turn
Seat 2: phong514 folded before Flop (didn't bet)
Seat 3: fiks7 collected (1053)
Seat 4: celfrieling folded before Flop (didn't bet)
Seat 5: catblu2 folded before Flop (didn't bet)
Seat 6: monaco2624 folded before Flop (didn't bet)
Seat 7: VodkaForMe folded before Flop (didn't bet)
Seat 8: malik_msk (button) folded before Flop (didn't bet)
Seat 9: Kühne1984 (small blind) folded on the River



PokerStars Game #70063784757: Tournament #545010286, $5.00+$0.50 USD Hold'em No Limit - Level V (30/60) - 2011/11/05 17:49:13 MSK [2011/11/05 9:49:13 ET]
Table '545010286 255' 9-max Seat #9 is the button
Seat 1: timbermendes (3740 in chips) 
Seat 2: phong514 (3100 in chips) 
Seat 3: fiks7 (8774 in chips) 
Seat 4: celfrieling (5887 in chips) 
Seat 5: catblu2 (1316 in chips) 
Seat 6: monaco2624 (5630 in chips) 
Seat 7: VodkaForMe (6640 in chips) 
Seat 8: malik_msk (16080 in chips) 
Seat 9: Kühne1984 (2520 in chips) 
timbermendes: posts the ante 5
phong514: posts the ante 5
fiks7: posts the ante 5
celfrieling: posts the ante 5
catblu2: posts the ante 5
monaco2624: posts the ante 5
VodkaForMe: posts the ante 5
malik_msk: posts the ante 5
Kühne1984: posts the ante 5
timbermendes: posts small blind 30
phong514: posts big blind 60
*** HOLE CARDS ***
Dealt to malik_msk [Ks 4h]
fiks7: folds 
malik_msk said, "krasava"
celfrieling: raises 69 to 129
catblu2: folds 
monaco2624: folds 
VodkaForMe: calls 129
malik_msk: folds 
Kühne1984: folds 
timbermendes: folds 
phong514: folds 
*** FLOP *** [3d 7d 8s]
celfrieling: bets 235
VodkaForMe: raises 605 to 840
celfrieling: folds 
Uncalled bet (605) returned to VodkaForMe
VodkaForMe collected 863 from pot
VodkaForMe: doesn't show hand 
*** SUMMARY ***
Total pot 863 | Rake 0 
Board [3d 7d 8s]
Seat 1: timbermendes (small blind) folded before Flop
Seat 2: phong514 (big blind) folded before Flop
Seat 3: fiks7 folded before Flop (didn't bet)
Seat 4: celfrieling folded on the Flop
Seat 5: catblu2 folded before Flop (didn't bet)
Seat 6: monaco2624 folded before Flop (didn't bet)
Seat 7: VodkaForMe collected (863)
Seat 8: malik_msk folded before Flop (didn't bet)
Seat 9: Kühne1984 (button) folded before Flop (didn't bet)



PokerStars Game #70063854892: Tournament #545010286, $5.00+$0.50 USD Hold'em No Limit - Level VI (40/80) - 2011/11/05 17:50:55 MSK [2011/11/05 9:50:55 ET]
Table '545010286 255' 9-max Seat #1 is the button
Seat 1: timbermendes (3705 in chips) 
Seat 2: phong514 (3035 in chips) 
Seat 3: fiks7 (8769 in chips) 
Seat 4: celfrieling (5518 in chips) 
Seat 5: catblu2 (1311 in chips) 
Seat 6: monaco2624 (5625 in chips) 
Seat 7: VodkaForMe (7134 in chips) 
Seat 8: malik_msk (16075 in chips) 
Seat 9: Kühne1984 (2515 in chips) 
timbermendes: posts the ante 10
phong514: posts the ante 10
fiks7: posts the ante 10
celfrieling: posts the ante 10
catblu2: posts the ante 10
monaco2624: posts the ante 10
VodkaForMe: posts the ante 10
malik_msk: posts the ante 10
Kühne1984: posts the ante 10
phong514: posts small blind 40
fiks7: posts big blind 80
*** HOLE CARDS ***
Dealt to malik_msk [Qs 6c]
celfrieling: raises 92 to 172
catblu2: folds 
monaco2624: folds 
VodkaForMe: folds 
malik_msk: folds 
Kühne1984: calls 172
timbermendes: folds 
phong514: folds 
fiks7: calls 92
*** FLOP *** [6h 3c 3d]
fiks7: checks 
celfrieling: checks 
Kühne1984: checks 
*** TURN *** [6h 3c 3d] [7h]
fiks7: bets 333
celfrieling: folds 
Kühne1984: folds 
Uncalled bet (333) returned to fiks7
fiks7 collected 646 from pot
*** SUMMARY ***
Total pot 646 | Rake 0 
Board [6h 3c 3d 7h]
Seat 1: timbermendes (button) folded before Flop (didn't bet)
Seat 2: phong514 (small blind) folded before Flop
Seat 3: fiks7 (big blind) collected (646)
Seat 4: celfrieling folded on the Turn
Seat 5: catblu2 folded before Flop (didn't bet)
Seat 6: monaco2624 folded before Flop (didn't bet)
Seat 7: VodkaForMe folded before Flop (didn't bet)
Seat 8: malik_msk folded before Flop (didn't bet)
Seat 9: Kühne1984 folded on the Turn



PokerStars Game #70063895485: Tournament #545010286, $5.00+$0.50 USD Hold'em No Limit - Level VI (40/80) - 2011/11/05 17:51:53 MSK [2011/11/05 9:51:53 ET]
Table '545010286 255' 9-max Seat #2 is the button
Seat 1: timbermendes (3695 in chips) 
Seat 2: phong514 (2985 in chips) 
Seat 3: fiks7 (9233 in chips) 
Seat 4: celfrieling (5336 in chips) 
Seat 5: catblu2 (1301 in chips) 
Seat 6: monaco2624 (5615 in chips) 
Seat 7: VodkaForMe (7124 in chips) 
Seat 8: malik_msk (16065 in chips) 
Seat 9: Kühne1984 (2333 in chips) 
timbermendes: posts the ante 10
phong514: posts the ante 10
fiks7: posts the ante 10
celfrieling: posts the ante 10
catblu2: posts the ante 10
monaco2624: posts the ante 10
VodkaForMe: posts the ante 10
malik_msk: posts the ante 10
Kühne1984: posts the ante 10
fiks7: posts small blind 40
celfrieling: posts big blind 80
*** HOLE CARDS ***
Dealt to malik_msk [4s Kh]
catblu2: folds 
monaco2624: raises 80 to 160
VodkaForMe: folds 
malik_msk: folds 
Kühne1984: folds 
timbermendes: calls 160
phong514: folds 
fiks7: raises 428 to 588
celfrieling: folds 
monaco2624: calls 428
timbermendes: calls 428
*** FLOP *** [Th Kd Jc]
fiks7: bets 555
monaco2624: calls 555
timbermendes: calls 555
*** TURN *** [Th Kd Jc] [6s]
fiks7: bets 1234
monaco2624: folds 
timbermendes: raises 1308 to 2542 and is all-in
fiks7: calls 1308
*** RIVER *** [Th Kd Jc 6s] [3s]
*** SHOW DOWN ***
fiks7: shows [Qd Ad] (a straight, Ten to Ace)
timbermendes: shows [Jh 7c] (a pair of Jacks)
fiks7 collected 8683 from pot
timbermendes finished the tournament in 2868th place
monaco2624 said, "lol"
*** SUMMARY ***
Total pot 8683 | Rake 0 
Board [Th Kd Jc 6s 3s]
Seat 1: timbermendes showed [Jh 7c] and lost with a pair of Jacks
Seat 2: phong514 (button) folded before Flop (didn't bet)
Seat 3: fiks7 (small blind) showed [Qd Ad] and won (8683) with a straight, Ten to Ace
Seat 4: celfrieling (big blind) folded before Flop
Seat 5: catblu2 folded before Flop (didn't bet)
Seat 6: monaco2624 folded on the Turn
Seat 7: VodkaForMe folded before Flop (didn't bet)
Seat 8: malik_msk folded before Flop (didn't bet)
Seat 9: Kühne1984 folded before Flop (didn't bet)



PokerStars Game #70063954824: Tournament #545010286, $5.00+$0.50 USD Hold'em No Limit - Level VI (40/80) - 2011/11/05 17:53:20 MSK [2011/11/05 9:53:20 ET]
Table '545010286 255' 9-max Seat #3 is the button
Seat 2: phong514 (2975 in chips) 
Seat 3: fiks7 (14221 in chips) 
Seat 4: celfrieling (5246 in chips) 
Seat 5: catblu2 (1291 in chips) 
Seat 6: monaco2624 (4462 in chips) 
Seat 7: VodkaForMe (7114 in chips) 
Seat 8: malik_msk (16055 in chips) 
Seat 9: Kühne1984 (2323 in chips) 
phong514: posts the ante 10
fiks7: posts the ante 10
celfrieling: posts the ante 10
catblu2: posts the ante 10
monaco2624: posts the ante 10
VodkaForMe: posts the ante 10
malik_msk: posts the ante 10
Kühne1984: posts the ante 10
celfrieling: posts small blind 40
catblu2: posts big blind 80
*** HOLE CARDS ***
Dealt to malik_msk [6c Qd]
monaco2624: folds 
malik_msk said, "nuts lol"
VodkaForMe: folds 
barby6969 is connected 
malik_msk: folds 
Kühne1984: raises 160 to 240
phong514: folds 
fiks7: folds 
celfrieling: folds 
catblu2: folds 
Uncalled bet (160) returned to Kühne1984
Kühne1984 collected 280 from pot
Kühne1984: doesn't show hand 
*** SUMMARY ***
Total pot 280 | Rake 0 
Seat 2: phong514 folded before Flop (didn't bet)
Seat 3: fiks7 (button) folded before Flop (didn't bet)
Seat 4: celfrieling (small blind) folded before Flop
Seat 5: catblu2 (big blind) folded before Flop
Seat 6: monaco2624 folded before Flop (didn't bet)
Seat 7: VodkaForMe folded before Flop (didn't bet)
Seat 8: malik_msk folded before Flop (didn't bet)
Seat 9: Kühne1984 collected (280)



PokerStars Game #70063971435: Tournament #545010286, $5.00+$0.50 USD Hold'em No Limit - Level VI (40/80) - 2011/11/05 17:53:44 MSK [2011/11/05 9:53:44 ET]
Table '545010286 255' 9-max Seat #4 is the button
Seat 1: barby6969 (3000 in chips) 
Seat 2: phong514 (2965 in chips) 
Seat 3: fiks7 (14211 in chips) 
Seat 4: celfrieling (5196 in chips) 
Seat 5: catblu2 (1201 in chips) 
Seat 6: monaco2624 (4452 in chips) 
Seat 7: VodkaForMe (7104 in chips) 
Seat 8: malik_msk (16045 in chips) 
Seat 9: Kühne1984 (2513 in chips) 
barby6969: posts the ante 10
phong514: posts the ante 10
fiks7: posts the ante 10
celfrieling: posts the ante 10
catblu2: posts the ante 10
monaco2624: posts the ante 10
VodkaForMe: posts the ante 10
malik_msk: posts the ante 10
Kühne1984: posts the ante 10
catblu2: posts small blind 40
monaco2624: posts big blind 80
*** HOLE CARDS ***
Dealt to malik_msk [Qh 2h]
VodkaForMe: raises 80 to 160
malik_msk: calls 160
Kühne1984: folds 
barby6969: folds 
phong514: folds 
fiks7: folds 
celfrieling: folds 
catblu2: raises 1031 to 1191 and is all-in
monaco2624: folds 
VodkaForMe: folds 
malik_msk: folds 
Uncalled bet (1031) returned to catblu2
catblu2 collected 650 from pot
catblu2: doesn't show hand 
*** SUMMARY ***
Total pot 650 | Rake 0 
Seat 1: barby6969 folded before Flop (didn't bet)
Seat 2: phong514 folded before Flop (didn't bet)
Seat 3: fiks7 folded before Flop (didn't bet)
Seat 4: celfrieling (button) folded before Flop (didn't bet)
Seat 5: catblu2 (small blind) collected (650)
Seat 6: monaco2624 (big blind) folded before Flop
Seat 7: VodkaForMe folded before Flop
Seat 8: malik_msk folded before Flop
Seat 9: Kühne1984 folded before Flop (didn't bet)



PokerStars Game #70063995853: Tournament #545010286, $5.00+$0.50 USD Hold'em No Limit - Level VI (40/80) - 2011/11/05 17:54:20 MSK [2011/11/05 9:54:20 ET]
Table '545010286 255' 9-max Seat #5 is the button
Seat 1: barby6969 (2990 in chips) 
Seat 2: phong514 (2955 in chips) 
Seat 3: fiks7 (14201 in chips) 
Seat 4: celfrieling (5186 in chips) 
Seat 5: catblu2 (1681 in chips) 
Seat 6: monaco2624 (4362 in chips) 
Seat 7: VodkaForMe (6934 in chips) 
Seat 8: malik_msk (15875 in chips) 
Seat 9: Kühne1984 (2503 in chips) 
barby6969: posts the ante 10
phong514: posts the ante 10
fiks7: posts the ante 10
celfrieling: posts the ante 10
catblu2: posts the ante 10
monaco2624: posts the ante 10
VodkaForMe: posts the ante 10
malik_msk: posts the ante 10
Kühne1984: posts the ante 10
monaco2624: posts small blind 40
VodkaForMe: posts big blind 80
*** HOLE CARDS ***
Dealt to malik_msk [Jh Qc]
malik_msk said, "vodka, vkolol by ya by upal"
malik_msk: calls 80
Kühne1984: folds 
barby6969: folds 
phong514: folds 
fiks7: folds 
celfrieling: folds 
catblu2: calls 80
monaco2624: folds 
VodkaForMe: raises 160 to 240
malik_msk: calls 160
catblu2: calls 160
*** FLOP *** [Ts Qh Kc]
VodkaForMe: checks 
malik_msk: checks 
catblu2: checks 
*** TURN *** [Ts Qh Kc] [Kd]
VodkaForMe: bets 320
malik_msk: calls 320
catblu2: folds 
*** RIVER *** [Ts Qh Kc Kd] [Ad]
VodkaForMe: bets 560
malik_msk: calls 560
*** SHOW DOWN ***
VodkaForMe: shows [6h 9h] (a pair of Kings)
malik_msk: shows [Jh Qc] (a straight, Ten to Ace)
malik_msk collected 2610 from pot
*** SUMMARY ***
Total pot 2610 | Rake 0 
Board [Ts Qh Kc Kd Ad]
Seat 1: barby6969 folded before Flop (didn't bet)
Seat 2: phong514 folded before Flop (didn't bet)
Seat 3: fiks7 folded before Flop (didn't bet)
Seat 4: celfrieling folded before Flop (didn't bet)
Seat 5: catblu2 (button) folded on the Turn
Seat 6: monaco2624 (small blind) folded before Flop
Seat 7: VodkaForMe (big blind) showed [6h 9h] and lost with a pair of Kings
Seat 8: malik_msk showed [Jh Qc] and won (2610) with a straight, Ten to Ace
Seat 9: Kühne1984 folded before Flop (didn't bet)



PokerStars Game #70064288567: Tournament #545010286, $5.00+$0.50 USD Hold'em No Limit - Level VI (40/80) - 2011/11/05 18:02:38 MSK [2011/11/05 10:02:38 ET]
Table '545010286 255' 9-max Seat #6 is the button
Seat 1: barby6969 (2980 in chips) 
Seat 2: phong514 (2945 in chips) 
Seat 3: fiks7 (14191 in chips) 
Seat 4: celfrieling (5176 in chips) 
Seat 5: catblu2 (1431 in chips) 
Seat 6: monaco2624 (4312 in chips) 
Seat 7: VodkaForMe (5804 in chips) 
Seat 8: malik_msk (17355 in chips) 
Seat 9: Kühne1984 (2493 in chips) 
barby6969: posts the ante 10
phong514: posts the ante 10
fiks7: posts the ante 10
celfrieling: posts the ante 10
catblu2: posts the ante 10
monaco2624: posts the ante 10
VodkaForMe: posts the ante 10
malik_msk: posts the ante 10
Kühne1984: posts the ante 10
VodkaForMe: posts small blind 40
malik_msk: posts big blind 80
*** HOLE CARDS ***
Dealt to malik_msk [Ah Ts]
Kühne1984: folds 
barby6969: folds 
phong514: folds 
fiks7: folds 
celfrieling: folds 
catblu2: folds 
monaco2624: raises 80 to 160
VodkaForMe: raises 160 to 320
malik_msk: folds 
monaco2624: calls 160
*** FLOP *** [Th 4s 6c]
VodkaForMe: bets 720
monaco2624: folds 
Uncalled bet (720) returned to VodkaForMe
VodkaForMe collected 810 from pot
VodkaForMe: doesn't show hand 
*** SUMMARY ***
Total pot 810 | Rake 0 
Board [Th 4s 6c]
Seat 1: barby6969 folded before Flop (didn't bet)
Seat 2: phong514 folded before Flop (didn't bet)
Seat 3: fiks7 folded before Flop (didn't bet)
Seat 4: celfrieling folded before Flop (didn't bet)
Seat 5: catblu2 folded before Flop (didn't bet)
Seat 6: monaco2624 (button) folded on the Flop
Seat 7: VodkaForMe (small blind) collected (810)
Seat 8: malik_msk (big blind) folded before Flop
Seat 9: Kühne1984 folded before Flop (didn't bet)



PokerStars Game #70064330063: Tournament #545010286, $5.00+$0.50 USD Hold'em No Limit - Level VI (40/80) - 2011/11/05 18:03:35 MSK [2011/11/05 10:03:35 ET]
Table '545010286 255' 9-max Seat #7 is the button
Seat 1: barby6969 (2970 in chips) 
Seat 2: phong514 (2935 in chips) 
Seat 3: fiks7 (14181 in chips) 
Seat 4: celfrieling (5166 in chips) 
Seat 5: catblu2 (1421 in chips) 
Seat 6: monaco2624 (3982 in chips) 
Seat 7: VodkaForMe (6284 in chips) 
Seat 8: malik_msk (17265 in chips) 
Seat 9: Kühne1984 (2483 in chips) 
barby6969: posts the ante 10
phong514: posts the ante 10
fiks7: posts the ante 10
celfrieling: posts the ante 10
catblu2: posts the ante 10
monaco2624: posts the ante 10
VodkaForMe: posts the ante 10
malik_msk: posts the ante 10
Kühne1984: posts the ante 10
malik_msk: posts small blind 40
Kühne1984: posts big blind 80
*** HOLE CARDS ***
Dealt to malik_msk [Kh 9h]
barby6969: folds 
phong514: folds 
fiks7: folds 
celfrieling: folds 
catblu2: folds 
monaco2624: raises 80 to 160
VodkaForMe: folds 
malik_msk: calls 120
Kühne1984: calls 80
*** FLOP *** [6d Ah Kd]
malik_msk: checks 
Kühne1984: checks 
monaco2624: checks 
*** TURN *** [6d Ah Kd] [6c]
malik_msk: bets 80
Kühne1984: folds 
monaco2624: calls 80
*** RIVER *** [6d Ah Kd 6c] [Qh]
malik_msk: bets 80
monaco2624: calls 80
*** SHOW DOWN ***
malik_msk: shows [Kh 9h] (two pair, Kings and Sixes)
monaco2624: mucks hand 
malik_msk collected 890 from pot
*** SUMMARY ***
Total pot 890 | Rake 0 
Board [6d Ah Kd 6c Qh]
Seat 1: barby6969 folded before Flop (didn't bet)
Seat 2: phong514 folded before Flop (didn't bet)
Seat 3: fiks7 folded before Flop (didn't bet)
Seat 4: celfrieling folded before Flop (didn't bet)
Seat 5: catblu2 folded before Flop (didn't bet)
Seat 6: monaco2624 mucked [4h 4d]
Seat 7: VodkaForMe (button) folded before Flop (didn't bet)
Seat 8: malik_msk (small blind) showed [Kh 9h] and won (890) with two pair, Kings and Sixes
Seat 9: Kühne1984 (big blind) folded on the Turn



PokerStars Game #70064387374: Tournament #545010286, $5.00+$0.50 USD Hold'em No Limit - Level VI (40/80) - 2011/11/05 18:04:54 MSK [2011/11/05 10:04:54 ET]
Table '545010286 255' 9-max Seat #8 is the button
Seat 1: barby6969 (2960 in chips) 
Seat 2: phong514 (2925 in chips) 
Seat 3: fiks7 (14171 in chips) 
Seat 4: celfrieling (5156 in chips) 
Seat 5: catblu2 (1411 in chips) 
Seat 6: monaco2624 (3652 in chips) 
Seat 7: VodkaForMe (6274 in chips) 
Seat 8: malik_msk (17825 in chips) 
Seat 9: Kühne1984 (2313 in chips) 
barby6969: posts the ante 10
phong514: posts the ante 10
fiks7: posts the ante 10
celfrieling: posts the ante 10
catblu2: posts the ante 10
monaco2624: posts the ante 10
VodkaForMe: posts the ante 10
malik_msk: posts the ante 10
Kühne1984: posts the ante 10
Kühne1984: posts small blind 40
barby6969: posts big blind 80
*** HOLE CARDS ***
Dealt to malik_msk [8s 5c]
phong514: folds 
fiks7: folds 
celfrieling: folds 
catblu2: calls 80
monaco2624: folds 
VodkaForMe: raises 80 to 160
malik_msk: folds 
Kühne1984: folds 
barby6969: calls 80
catblu2: calls 80
*** FLOP *** [Kc Kh 5h]
barby6969: checks 
catblu2: bets 480
VodkaForMe: folds 
barby6969: folds 
Uncalled bet (480) returned to catblu2
catblu2 collected 610 from pot
catblu2: doesn't show hand 
*** SUMMARY ***
Total pot 610 | Rake 0 
Board [Kc Kh 5h]
Seat 1: barby6969 (big blind) folded on the Flop
Seat 2: phong514 folded before Flop (didn't bet)
Seat 3: fiks7 folded before Flop (didn't bet)
Seat 4: celfrieling folded before Flop (didn't bet)
Seat 5: catblu2 collected (610)
Seat 6: monaco2624 folded before Flop (didn't bet)
Seat 7: VodkaForMe folded on the Flop
Seat 8: malik_msk (button) folded before Flop (didn't bet)
Seat 9: Kühne1984 (small blind) folded before Flop



PokerStars Game #70064416697: Tournament #545010286, $5.00+$0.50 USD Hold'em No Limit - Level VI (40/80) - 2011/11/05 18:05:33 MSK [2011/11/05 10:05:33 ET]
Table '545010286 255' 9-max Seat #9 is the button
Seat 1: barby6969 (2790 in chips) 
Seat 2: phong514 (2915 in chips) 
Seat 3: fiks7 (14161 in chips) 
Seat 4: celfrieling (5146 in chips) 
Seat 5: catblu2 (1851 in chips) 
Seat 6: monaco2624 (3642 in chips) 
Seat 7: VodkaForMe (6104 in chips) 
Seat 8: malik_msk (17815 in chips) 
Seat 9: Kühne1984 (2263 in chips) 
barby6969: posts the ante 10
phong514: posts the ante 10
fiks7: posts the ante 10
celfrieling: posts the ante 10
catblu2: posts the ante 10
monaco2624: posts the ante 10
VodkaForMe: posts the ante 10
malik_msk: posts the ante 10
Kühne1984: posts the ante 10
barby6969: posts small blind 40
phong514: posts big blind 80
*** HOLE CARDS ***
Dealt to malik_msk [Js Ad]
fiks7: folds 
celfrieling: folds 
catblu2: calls 80
monaco2624: folds 
VodkaForMe: folds 
malik_msk: raises 80 to 160
Kühne1984: folds 
barby6969: folds 
phong514: calls 80
catblu2: calls 80
*** FLOP *** [Qc 2s 8d]
phong514: checks 
catblu2: checks 
malik_msk: bets 320
phong514: folds 
catblu2: raises 1361 to 1681 and is all-in
malik_msk: folds 
Uncalled bet (1361) returned to catblu2
catblu2 collected 1250 from pot
*** SUMMARY ***
Total pot 1250 | Rake 0 
Board [Qc 2s 8d]
Seat 1: barby6969 (small blind) folded before Flop
Seat 2: phong514 (big blind) folded on the Flop
Seat 3: fiks7 folded before Flop (didn't bet)
Seat 4: celfrieling folded before Flop (didn't bet)
Seat 5: catblu2 collected (1250)
Seat 6: monaco2624 folded before Flop (didn't bet)
Seat 7: VodkaForMe folded before Flop (didn't bet)
Seat 8: malik_msk folded on the Flop
Seat 9: Kühne1984 (button) folded before Flop (didn't bet)



PokerStars Game #70064480922: Tournament #545010286, $5.00+$0.50 USD Hold'em No Limit - Level VI (40/80) - 2011/11/05 18:07:00 MSK [2011/11/05 10:07:00 ET]
Table '545010286 255' 9-max Seat #1 is the button
Seat 1: barby6969 (2740 in chips) 
Seat 2: phong514 (2745 in chips) 
Seat 3: fiks7 (14151 in chips) 
Seat 4: celfrieling (5136 in chips) 
Seat 5: catblu2 (2611 in chips) 
Seat 6: monaco2624 (3632 in chips) 
Seat 7: VodkaForMe (6094 in chips) 
Seat 8: malik_msk (17325 in chips) 
Seat 9: Kühne1984 (2253 in chips) 
barby6969: posts the ante 10
phong514: posts the ante 10
fiks7: posts the ante 10
celfrieling: posts the ante 10
catblu2: posts the ante 10
monaco2624: posts the ante 10
VodkaForMe: posts the ante 10
malik_msk: posts the ante 10
Kühne1984: posts the ante 10
phong514: posts small blind 40
fiks7: posts big blind 80
*** HOLE CARDS ***
Dealt to malik_msk [Th 2s]
celfrieling: folds 
catblu2: folds 
monaco2624: folds 
VodkaForMe: raises 80 to 160
malik_msk: folds 
Kühne1984: calls 160
barby6969: calls 160
phong514: folds 
fiks7: folds 
*** FLOP *** [As Qc Qs]
VodkaForMe: checks 
Kühne1984: checks 
barby6969: checks 
*** TURN *** [As Qc Qs] [6s]
VodkaForMe: bets 240
Kühne1984: folds 
barby6969: calls 240
*** RIVER *** [As Qc Qs 6s] [9c]
VodkaForMe: bets 560
barby6969: calls 560
*** SHOW DOWN ***
VodkaForMe: shows [2h 4h] (a pair of Queens)
barby6969: shows [Ts Ah] (two pair, Aces and Queens)
barby6969 collected 2290 from pot
*** SUMMARY ***
Total pot 2290 | Rake 0 
Board [As Qc Qs 6s 9c]
Seat 1: barby6969 (button) showed [Ts Ah] and won (2290) with two pair, Aces and Queens
Seat 2: phong514 (small blind) folded before Flop
Seat 3: fiks7 (big blind) folded before Flop
Seat 4: celfrieling folded before Flop (didn't bet)
Seat 5: catblu2 folded before Flop (didn't bet)
Seat 6: monaco2624 folded before Flop (didn't bet)
Seat 7: VodkaForMe showed [2h 4h] and lost with a pair of Queens
Seat 8: malik_msk folded before Flop (didn't bet)
Seat 9: Kühne1984 folded on the Turn



PokerStars Game #70064531150: Tournament #545010286, $5.00+$0.50 USD Hold'em No Limit - Level VII (50/100) - 2011/11/05 18:08:08 MSK [2011/11/05 10:08:08 ET]
Table '545010286 255' 9-max Seat #2 is the button
Seat 1: barby6969 (4060 in chips) 
Seat 2: phong514 (2695 in chips) 
Seat 3: fiks7 (14061 in chips) 
Seat 4: celfrieling (5126 in chips) 
Seat 5: catblu2 (2601 in chips) 
Seat 6: monaco2624 (3622 in chips) 
Seat 7: VodkaForMe (5124 in chips) 
Seat 8: malik_msk (17315 in chips) 
Seat 9: Kühne1984 (2083 in chips) 
barby6969: posts the ante 10
phong514: posts the ante 10
fiks7: posts the ante 10
celfrieling: posts the ante 10
catblu2: posts the ante 10
monaco2624: posts the ante 10
VodkaForMe: posts the ante 10
malik_msk: posts the ante 10
Kühne1984: posts the ante 10
fiks7: posts small blind 50
celfrieling: posts big blind 100
*** HOLE CARDS ***
Dealt to malik_msk [6c Qs]
malik_msk said, "weird bluff"
catblu2: folds 
monaco2624: folds 
VodkaForMe: raises 100 to 200
malik_msk: folds 
Kühne1984: folds 
barby6969: calls 200
malik_msk said, "ty mastak blefovat s der'mom"
phong514: raises 700 to 900
fiks7: folds 
celfrieling: folds 
VodkaForMe said, "no bluff , nh"
fiks7 said, "on prosto ly4shii"
VodkaForMe: folds 
barby6969: calls 700
*** FLOP *** [8s 2s 2c]
barby6969: bets 1000
phong514: raises 785 to 1785 and is all-in
barby6969: calls 785
malik_msk said, "eto daaa :) u nego dve karty, ne huhry muhry"
*** TURN *** [8s 2s 2c] [Qh]
*** RIVER *** [8s 2s 2c Qh] [Jh]
*** SHOW DOWN ***
barby6969: shows [2h Kh] (three of a kind, Deuces)
phong514: shows [Kd Kc] (two pair, Kings and Deuces)
barby6969 collected 5810 from pot
*** SUMMARY ***
Total pot 5810 | Rake 0 
Board [8s 2s 2c Qh Jh]
Seat 1: barby6969 showed [2h Kh] and won (5810) with three of a kind, Deuces
Seat 2: phong514 (button) showed [Kd Kc] and lost with two pair, Kings and Deuces
Seat 3: fiks7 (small blind) folded before Flop
Seat 4: celfrieling (big blind) folded before Flop
Seat 5: catblu2 folded before Flop (didn't bet)
Seat 6: monaco2624 folded before Flop (didn't bet)
Seat 7: VodkaForMe folded before Flop
Seat 8: malik_msk folded before Flop (didn't bet)
Seat 9: Kühne1984 folded before Flop (didn't bet)



PokerStars Game #70064647704: Tournament #545010286, $5.00+$0.50 USD Hold'em No Limit - Level VII (50/100) - 2011/11/05 18:10:46 MSK [2011/11/05 10:10:46 ET]
Table '545010286 77' 9-max Seat #9 is the button
Seat 1: whitepaper38 (5980 in chips) 
Seat 2: Killererin (15592 in chips) 
Seat 3: malik_msk (17305 in chips) 
Seat 4: Dillabeat (4560 in chips) 
Seat 5: kruiiser (3054 in chips) 
Seat 6: popizdiš (2700 in chips) 
Seat 7: Highländer64 (2500 in chips) 
Seat 8: mx.Timo (8996 in chips) 
Seat 9: Pete55558 (12933 in chips) 
whitepaper38: posts the ante 10
Killererin: posts the ante 10
malik_msk: posts the ante 10
Dillabeat: posts the ante 10
kruiiser: posts the ante 10
popizdiš: posts the ante 10
Highländer64: posts the ante 10
mx.Timo: posts the ante 10
Pete55558: posts the ante 10
whitepaper38: posts small blind 50
Killererin: posts big blind 100
*** HOLE CARDS ***
Dealt to malik_msk [Kd 2d]
malik_msk: folds 
Dillabeat: folds 
kruiiser: folds 
popizdiš: folds 
Highländer64: folds 
mx.Timo: folds 
Pete55558: folds 
whitepaper38: folds 
Uncalled bet (50) returned to Killererin
Killererin collected 190 from pot
Killererin: doesn't show hand 
*** SUMMARY ***
Total pot 190 | Rake 0 
Seat 1: whitepaper38 (small blind) folded before Flop
Seat 2: Killererin (big blind) collected (190)
Seat 3: malik_msk folded before Flop (didn't bet)
Seat 4: Dillabeat folded before Flop (didn't bet)
Seat 5: kruiiser folded before Flop (didn't bet)
Seat 6: popizdiš folded before Flop (didn't bet)
Seat 7: Highländer64 folded before Flop (didn't bet)
Seat 8: mx.Timo folded before Flop (didn't bet)
Seat 9: Pete55558 (button) folded before Flop (didn't bet)



PokerStars Game #70064661669: Tournament #545010286, $5.00+$0.50 USD Hold'em No Limit - Level VII (50/100) - 2011/11/05 18:11:05 MSK [2011/11/05 10:11:05 ET]
Table '545010286 77' 9-max Seat #1 is the button
Seat 1: whitepaper38 (5920 in chips) 
Seat 2: Killererin (15722 in chips) 
Seat 3: malik_msk (17295 in chips) 
Seat 4: Dillabeat (4550 in chips) 
Seat 5: kruiiser (3044 in chips) 
Seat 6: popizdiš (2690 in chips) 
Seat 7: Highländer64 (2490 in chips) 
Seat 8: mx.Timo (8986 in chips) 
Seat 9: Pete55558 (12923 in chips) 
whitepaper38: posts the ante 10
Killererin: posts the ante 10
malik_msk: posts the ante 10
Dillabeat: posts the ante 10
kruiiser: posts the ante 10
popizdiš: posts the ante 10
Highländer64: posts the ante 10
mx.Timo: posts the ante 10
Pete55558: posts the ante 10
Killererin: posts small blind 50
malik_msk: posts big blind 100
*** HOLE CARDS ***
Dealt to malik_msk [Js Ah]
Dillabeat: folds 
kruiiser: calls 100
popizdiš: folds 
Highländer64: folds 
mx.Timo: folds 
Pete55558: folds 
whitepaper38: folds 
Killererin: calls 50
malik_msk: checks 
*** FLOP *** [Ks 2c Tc]
Killererin: checks 
malik_msk: checks 
kruiiser: bets 200
Killererin: folds 
malik_msk: calls 200
*** TURN *** [Ks 2c Tc] [6s]
malik_msk: checks 
kruiiser: bets 521
malik_msk: folds 
Uncalled bet (521) returned to kruiiser
kruiiser collected 790 from pot
*** SUMMARY ***
Total pot 790 | Rake 0 
Board [Ks 2c Tc 6s]
Seat 1: whitepaper38 (button) folded before Flop (didn't bet)
Seat 2: Killererin (small blind) folded on the Flop
Seat 3: malik_msk (big blind) folded on the Turn
Seat 4: Dillabeat folded before Flop (didn't bet)
Seat 5: kruiiser collected (790)
Seat 6: popizdiš folded before Flop (didn't bet)
Seat 7: Highländer64 folded before Flop (didn't bet)
Seat 8: mx.Timo folded before Flop (didn't bet)
Seat 9: Pete55558 folded before Flop (didn't bet)



PokerStars Game #70064702423: Tournament #545010286, $5.00+$0.50 USD Hold'em No Limit - Level VII (50/100) - 2011/11/05 18:12:01 MSK [2011/11/05 10:12:01 ET]
Table '545010286 77' 9-max Seat #2 is the button
Seat 1: whitepaper38 (5910 in chips) 
Seat 2: Killererin (15612 in chips) 
Seat 3: malik_msk (16985 in chips) 
Seat 4: Dillabeat (4540 in chips) 
Seat 5: kruiiser (3524 in chips) 
Seat 6: popizdiš (2680 in chips) 
Seat 7: Highländer64 (2480 in chips) 
Seat 8: mx.Timo (8976 in chips) 
Seat 9: Pete55558 (12913 in chips) 
whitepaper38: posts the ante 10
Killererin: posts the ante 10
malik_msk: posts the ante 10
Dillabeat: posts the ante 10
kruiiser: posts the ante 10
popizdiš: posts the ante 10
Highländer64: posts the ante 10
mx.Timo: posts the ante 10
Pete55558: posts the ante 10
malik_msk: posts small blind 50
Dillabeat: posts big blind 100
*** HOLE CARDS ***
Dealt to malik_msk [Th 3c]
kruiiser: folds 
popizdiš: folds 
Highländer64: folds 
mx.Timo: folds 
Pete55558: raises 150 to 250
whitepaper38: folds 
Killererin: folds 
malik_msk: folds 
Dillabeat: folds 
Uncalled bet (150) returned to Pete55558
Pete55558 collected 340 from pot
Pete55558: doesn't show hand 
*** SUMMARY ***
Total pot 340 | Rake 0 
Seat 1: whitepaper38 folded before Flop (didn't bet)
Seat 2: Killererin (button) folded before Flop (didn't bet)
Seat 3: malik_msk (small blind) folded before Flop
Seat 4: Dillabeat (big blind) folded before Flop
Seat 5: kruiiser folded before Flop (didn't bet)
Seat 6: popizdiš folded before Flop (didn't bet)
Seat 7: Highländer64 folded before Flop (didn't bet)
Seat 8: mx.Timo folded before Flop (didn't bet)
Seat 9: Pete55558 collected (340)



PokerStars Game #70064718199: Tournament #545010286, $5.00+$0.50 USD Hold'em No Limit - Level VII (50/100) - 2011/11/05 18:12:22 MSK [2011/11/05 10:12:22 ET]
Table '545010286 77' 9-max Seat #3 is the button
Seat 1: whitepaper38 (5900 in chips) 
Seat 2: Killererin (15602 in chips) 
Seat 3: malik_msk (16925 in chips) 
Seat 4: Dillabeat (4430 in chips) 
Seat 5: kruiiser (3514 in chips) 
Seat 6: popizdiš (2670 in chips) 
Seat 7: Highländer64 (2470 in chips) 
Seat 8: mx.Timo (8966 in chips) 
Seat 9: Pete55558 (13143 in chips) 
whitepaper38: posts the ante 10
Killererin: posts the ante 10
malik_msk: posts the ante 10
Dillabeat: posts the ante 10
kruiiser: posts the ante 10
popizdiš: posts the ante 10
Highländer64: posts the ante 10
mx.Timo: posts the ante 10
Pete55558: posts the ante 10
Dillabeat: posts small blind 50
kruiiser: posts big blind 100
*** HOLE CARDS ***
Dealt to malik_msk [Jh 4h]
popizdiš: calls 100
Highländer64: folds 
mx.Timo: folds 
Pete55558: calls 100
whitepaper38: folds 
Killererin: folds 
malik_msk: folds 
Dillabeat: calls 50
kruiiser: checks 
*** FLOP *** [Ts 3h 5s]
Dillabeat: bets 270
kruiiser: folds 
popizdiš: folds 
Pete55558: calls 270
*** TURN *** [Ts 3h 5s] [2c]
Dillabeat: bets 541
Pete55558: folds 
Uncalled bet (541) returned to Dillabeat
Dillabeat collected 1030 from pot
Dillabeat: doesn't show hand 
*** SUMMARY ***
Total pot 1030 | Rake 0 
Board [Ts 3h 5s 2c]
Seat 1: whitepaper38 folded before Flop (didn't bet)
Seat 2: Killererin folded before Flop (didn't bet)
Seat 3: malik_msk (button) folded before Flop (didn't bet)
Seat 4: Dillabeat (small blind) collected (1030)
Seat 5: kruiiser (big blind) folded on the Flop
Seat 6: popizdiš folded on the Flop
Seat 7: Highländer64 folded before Flop (didn't bet)
Seat 8: mx.Timo folded before Flop (didn't bet)
Seat 9: Pete55558 folded on the Turn



PokerStars Game #70064767266: Tournament #545010286, $5.00+$0.50 USD Hold'em No Limit - Level VII (50/100) - 2011/11/05 18:13:29 MSK [2011/11/05 10:13:29 ET]
Table '545010286 77' 9-max Seat #4 is the button
Seat 1: whitepaper38 (5890 in chips) 
Seat 2: Killererin (15592 in chips) 
Seat 3: malik_msk (16915 in chips) 
Seat 4: Dillabeat (5080 in chips) 
Seat 5: kruiiser (3404 in chips) 
Seat 6: popizdiš (2560 in chips) 
Seat 7: Highländer64 (2460 in chips) 
Seat 8: mx.Timo (8956 in chips) 
Seat 9: Pete55558 (12763 in chips) 
whitepaper38: posts the ante 10
Killererin: posts the ante 10
malik_msk: posts the ante 10
Dillabeat: posts the ante 10
kruiiser: posts the ante 10
popizdiš: posts the ante 10
Highländer64: posts the ante 10
mx.Timo: posts the ante 10
Pete55558: posts the ante 10
kruiiser: posts small blind 50
popizdiš: posts big blind 100
*** HOLE CARDS ***
Dealt to malik_msk [3s Kc]
Highländer64: folds 
mx.Timo: folds 
Pete55558: folds 
whitepaper38: folds 
Killererin: folds 
malik_msk: folds 
Dillabeat: folds 
kruiiser: raises 134 to 234
popizdiš: raises 2316 to 2550 and is all-in
kruiiser: folds 
Uncalled bet (2316) returned to popizdiš
popizdiš collected 558 from pot
*** SUMMARY ***
Total pot 558 | Rake 0 
Seat 1: whitepaper38 folded before Flop (didn't bet)
Seat 2: Killererin folded before Flop (didn't bet)
Seat 3: malik_msk folded before Flop (didn't bet)
Seat 4: Dillabeat (button) folded before Flop (didn't bet)
Seat 5: kruiiser (small blind) folded before Flop
Seat 6: popizdiš (big blind) collected (558)
Seat 7: Highländer64 folded before Flop (didn't bet)
Seat 8: mx.Timo folded before Flop (didn't bet)
Seat 9: Pete55558 folded before Flop (didn't bet)



PokerStars Game #70064788085: Tournament #545010286, $5.00+$0.50 USD Hold'em No Limit - Level VII (50/100) - 2011/11/05 18:13:57 MSK [2011/11/05 10:13:57 ET]
Table '545010286 77' 9-max Seat #5 is the button
Seat 1: whitepaper38 (5880 in chips) 
Seat 2: Killererin (15582 in chips) 
Seat 3: malik_msk (16905 in chips) 
Seat 4: Dillabeat (5070 in chips) 
Seat 5: kruiiser (3160 in chips) 
Seat 6: popizdiš (2874 in chips) 
Seat 7: Highländer64 (2450 in chips) 
Seat 8: mx.Timo (8946 in chips) 
Seat 9: Pete55558 (12753 in chips) 
whitepaper38: posts the ante 10
Killererin: posts the ante 10
malik_msk: posts the ante 10
Dillabeat: posts the ante 10
kruiiser: posts the ante 10
popizdiš: posts the ante 10
Highländer64: posts the ante 10
mx.Timo: posts the ante 10
Pete55558: posts the ante 10
popizdiš: posts small blind 50
Highländer64: posts big blind 100
*** HOLE CARDS ***
Dealt to malik_msk [Kc 2h]
mx.Timo: folds 
Pete55558: folds 
whitepaper38: folds 
Killererin: folds 
malik_msk: folds 
Dillabeat: folds 
kruiiser: folds 
popizdiš: calls 50
Highländer64: checks 
*** FLOP *** [6c Jd 4h]
popizdiš: bets 100
Highländer64: folds 
Uncalled bet (100) returned to popizdiš
popizdiš collected 290 from pot
*** SUMMARY ***
Total pot 290 | Rake 0 
Board [6c Jd 4h]
Seat 1: whitepaper38 folded before Flop (didn't bet)
Seat 2: Killererin folded before Flop (didn't bet)
Seat 3: malik_msk folded before Flop (didn't bet)
Seat 4: Dillabeat folded before Flop (didn't bet)
Seat 5: kruiiser (button) folded before Flop (didn't bet)
Seat 6: popizdiš (small blind) collected (290)
Seat 7: Highländer64 (big blind) folded on the Flop
Seat 8: mx.Timo folded before Flop (didn't bet)
Seat 9: Pete55558 folded before Flop (didn't bet)



PokerStars Game #70064836500: Tournament #545010286, $5.00+$0.50 USD Hold'em No Limit - Level VII (50/100) - 2011/11/05 18:15:03 MSK [2011/11/05 10:15:03 ET]
Table '545010286 77' 9-max Seat #6 is the button
Seat 1: whitepaper38 (5870 in chips) 
Seat 2: Killererin (15572 in chips) 
Seat 3: malik_msk (16895 in chips) 
Seat 4: Dillabeat (5060 in chips) 
Seat 5: kruiiser (3150 in chips) 
Seat 6: popizdiš (3054 in chips) 
Seat 7: Highländer64 (2340 in chips) 
Seat 8: mx.Timo (8936 in chips) 
Seat 9: Pete55558 (12743 in chips) 
whitepaper38: posts the ante 10
Killererin: posts the ante 10
malik_msk: posts the ante 10
Dillabeat: posts the ante 10
kruiiser: posts the ante 10
popizdiš: posts the ante 10
Highländer64: posts the ante 10
mx.Timo: posts the ante 10
Pete55558: posts the ante 10
Highländer64: posts small blind 50
mx.Timo: posts big blind 100
*** HOLE CARDS ***
Dealt to malik_msk [Qc Js]
Pete55558: calls 100
whitepaper38: folds 
Killererin: calls 100
malik_msk: raises 100 to 200
Dillabeat: folds 
kruiiser: folds 
popizdiš: folds 
Highländer64: folds 
mx.Timo: folds 
Pete55558: calls 100
Killererin: calls 100
*** FLOP *** [9d Jh Jd]
Pete55558: checks 
Killererin: checks 
malik_msk: bets 300
Pete55558: folds 
Killererin: folds 
Uncalled bet (300) returned to malik_msk
malik_msk collected 840 from pot
malik_msk: doesn't show hand 
*** SUMMARY ***
Total pot 840 | Rake 0 
Board [9d Jh Jd]
Seat 1: whitepaper38 folded before Flop (didn't bet)
Seat 2: Killererin folded on the Flop
Seat 3: malik_msk collected (840)
Seat 4: Dillabeat folded before Flop (didn't bet)
Seat 5: kruiiser folded before Flop (didn't bet)
Seat 6: popizdiš (button) folded before Flop (didn't bet)
Seat 7: Highländer64 (small blind) folded before Flop
Seat 8: mx.Timo (big blind) folded before Flop
Seat 9: Pete55558 folded on the Flop



PokerStars Game #70064879450: Tournament #545010286, $5.00+$0.50 USD Hold'em No Limit - Level VII (50/100) - 2011/11/05 18:16:01 MSK [2011/11/05 10:16:01 ET]
Table '545010286 77' 9-max Seat #7 is the button
Seat 1: whitepaper38 (5860 in chips) 
Seat 2: Killererin (15362 in chips) 
Seat 3: malik_msk (17525 in chips) 
Seat 4: Dillabeat (5050 in chips) 
Seat 5: kruiiser (3140 in chips) 
Seat 6: popizdiš (3044 in chips) 
Seat 7: Highländer64 (2280 in chips) 
Seat 8: mx.Timo (8826 in chips) 
Seat 9: Pete55558 (12533 in chips) 
whitepaper38: posts the ante 10
Killererin: posts the ante 10
malik_msk: posts the ante 10
Dillabeat: posts the ante 10
kruiiser: posts the ante 10
popizdiš: posts the ante 10
Highländer64: posts the ante 10
mx.Timo: posts the ante 10
Pete55558: posts the ante 10
mx.Timo: posts small blind 50
Pete55558: posts big blind 100
*** HOLE CARDS ***
Dealt to malik_msk [Qh 5s]
whitepaper38: folds 
Killererin: folds 
malik_msk: folds 
Dillabeat: folds 
kruiiser: folds 
popizdiš: calls 100
Highländer64: calls 100
mx.Timo: calls 50
Pete55558: checks 
*** FLOP *** [5c 7c Ks]
mx.Timo: checks 
Pete55558: checks 
popizdiš: checks 
Highländer64: checks 
*** TURN *** [5c 7c Ks] [2h]
mx.Timo: checks 
Pete55558: checks 
popizdiš: bets 300
Highländer64: folds 
mx.Timo: folds 
Pete55558: folds 
Uncalled bet (300) returned to popizdiš
popizdiš collected 490 from pot
*** SUMMARY ***
Total pot 490 | Rake 0 
Board [5c 7c Ks 2h]
Seat 1: whitepaper38 folded before Flop (didn't bet)
Seat 2: Killererin folded before Flop (didn't bet)
Seat 3: malik_msk folded before Flop (didn't bet)
Seat 4: Dillabeat folded before Flop (didn't bet)
Seat 5: kruiiser folded before Flop (didn't bet)
Seat 6: popizdiš collected (490)
Seat 7: Highländer64 (button) folded on the Turn
Seat 8: mx.Timo (small blind) folded on the Turn
Seat 9: Pete55558 (big blind) folded on the Turn



PokerStars Game #70064925378: Tournament #545010286, $5.00+$0.50 USD Hold'em No Limit - Level VII (50/100) - 2011/11/05 18:17:04 MSK [2011/11/05 10:17:04 ET]
Table '545010286 77' 9-max Seat #8 is the button
Seat 1: whitepaper38 (5850 in chips) 
Seat 2: Killererin (15352 in chips) 
Seat 3: malik_msk (17515 in chips) 
Seat 4: Dillabeat (5040 in chips) 
Seat 5: kruiiser (3130 in chips) 
Seat 6: popizdiš (3424 in chips) 
Seat 7: Highländer64 (2170 in chips) 
Seat 8: mx.Timo (8716 in chips) 
Seat 9: Pete55558 (12423 in chips) 
whitepaper38: posts the ante 10
Killererin: posts the ante 10
malik_msk: posts the ante 10
Dillabeat: posts the ante 10
kruiiser: posts the ante 10
popizdiš: posts the ante 10
Highländer64: posts the ante 10
mx.Timo: posts the ante 10
Pete55558: posts the ante 10
Pete55558: posts small blind 50
whitepaper38: posts big blind 100
*** HOLE CARDS ***
Dealt to malik_msk [9d 4s]
Killererin: folds 
malik_msk: folds 
Dillabeat: folds 
kruiiser: folds 
popizdiš: calls 100
Highländer64: folds 
mx.Timo: folds 
Pete55558: calls 50
whitepaper38: checks 
*** FLOP *** [3h 3d 6s]
Pete55558: checks 
whitepaper38: checks 
popizdiš: bets 300
Pete55558: folds 
whitepaper38: folds 
Uncalled bet (300) returned to popizdiš
popizdiš collected 390 from pot
*** SUMMARY ***
Total pot 390 | Rake 0 
Board [3h 3d 6s]
Seat 1: whitepaper38 (big blind) folded on the Flop
Seat 2: Killererin folded before Flop (didn't bet)
Seat 3: malik_msk folded before Flop (didn't bet)
Seat 4: Dillabeat folded before Flop (didn't bet)
Seat 5: kruiiser folded before Flop (didn't bet)
Seat 6: popizdiš collected (390)
Seat 7: Highländer64 folded before Flop (didn't bet)
Seat 8: mx.Timo (button) folded before Flop (didn't bet)
Seat 9: Pete55558 (small blind) folded on the Flop



PokerStars Game #70064953890: Tournament #545010286, $5.00+$0.50 USD Hold'em No Limit - Level VIII (60/120) - 2011/11/05 18:17:42 MSK [2011/11/05 10:17:42 ET]
Table '545010286 77' 9-max Seat #9 is the button
Seat 1: whitepaper38 (5740 in chips) 
Seat 2: Killererin (15342 in chips) 
Seat 3: malik_msk (17505 in chips) 
Seat 4: Dillabeat (5030 in chips) 
Seat 5: kruiiser (3120 in chips) 
Seat 6: popizdiš (3704 in chips) 
Seat 7: Highländer64 (2160 in chips) 
Seat 8: mx.Timo (8706 in chips) 
Seat 9: Pete55558 (12313 in chips) 
whitepaper38: posts the ante 15
Killererin: posts the ante 15
malik_msk: posts the ante 15
Dillabeat: posts the ante 15
kruiiser: posts the ante 15
popizdiš: posts the ante 15
Highländer64: posts the ante 15
mx.Timo: posts the ante 15
Pete55558: posts the ante 15
whitepaper38: posts small blind 60
Killererin: posts big blind 120
*** HOLE CARDS ***
Dealt to malik_msk [7d 3d]
malik_msk: folds 
Dillabeat: folds 
kruiiser: raises 180 to 300
popizdiš: folds 
Highländer64: folds 
mx.Timo: folds 
Pete55558: folds 
whitepaper38: folds 
Killererin: folds 
Uncalled bet (180) returned to kruiiser
kruiiser collected 435 from pot
*** SUMMARY ***
Total pot 435 | Rake 0 
Seat 1: whitepaper38 (small blind) folded before Flop
Seat 2: Killererin (big blind) folded before Flop
Seat 3: malik_msk folded before Flop (didn't bet)
Seat 4: Dillabeat folded before Flop (didn't bet)
Seat 5: kruiiser collected (435)
Seat 6: popizdiš folded before Flop (didn't bet)
Seat 7: Highländer64 folded before Flop (didn't bet)
Seat 8: mx.Timo folded before Flop (didn't bet)
Seat 9: Pete55558 (button) folded before Flop (didn't bet)



PokerStars Game #70064971523: Tournament #545010286, $5.00+$0.50 USD Hold'em No Limit - Level VIII (60/120) - 2011/11/05 18:18:06 MSK [2011/11/05 10:18:06 ET]
Table '545010286 77' 9-max Seat #1 is the button
Seat 1: whitepaper38 (5665 in chips) 
Seat 2: Killererin (15207 in chips) 
Seat 3: malik_msk (17490 in chips) 
Seat 4: Dillabeat (5015 in chips) 
Seat 5: kruiiser (3420 in chips) 
Seat 6: popizdiš (3689 in chips) 
Seat 7: Highländer64 (2145 in chips) 
Seat 8: mx.Timo (8691 in chips) 
Seat 9: Pete55558 (12298 in chips) 
whitepaper38: posts the ante 15
Killererin: posts the ante 15
malik_msk: posts the ante 15
Dillabeat: posts the ante 15
kruiiser: posts the ante 15
popizdiš: posts the ante 15
Highländer64: posts the ante 15
mx.Timo: posts the ante 15
Pete55558: posts the ante 15
Killererin: posts small blind 60
malik_msk: posts big blind 120
*** HOLE CARDS ***
Dealt to malik_msk [3s Qc]
Dillabeat: folds 
kruiiser: folds 
popizdiš: calls 120
Highländer64: folds 
mx.Timo: folds 
Pete55558: folds 
whitepaper38: calls 120
Killererin: calls 60
malik_msk: checks 
*** FLOP *** [5s Js 8c]
Killererin: checks 
malik_msk: checks 
popizdiš: checks 
whitepaper38: checks 
*** TURN *** [5s Js 8c] [Ad]
Killererin: checks 
malik_msk: folds 
popizdiš: bets 120
whitepaper38: folds 
Killererin: calls 120
*** RIVER *** [5s Js 8c Ad] [Jh]
Killererin: checks 
popizdiš: bets 120
Killererin: folds 
Uncalled bet (120) returned to popizdiš
popizdiš collected 855 from pot
*** SUMMARY ***
Total pot 855 | Rake 0 
Board [5s Js 8c Ad Jh]
Seat 1: whitepaper38 (button) folded on the Turn
Seat 2: Killererin (small blind) folded on the River
Seat 3: malik_msk (big blind) folded on the Turn
Seat 4: Dillabeat folded before Flop (didn't bet)
Seat 5: kruiiser folded before Flop (didn't bet)
Seat 6: popizdiš collected (855)
Seat 7: Highländer64 folded before Flop (didn't bet)
Seat 8: mx.Timo folded before Flop (didn't bet)
Seat 9: Pete55558 folded before Flop (didn't bet)



PokerStars Game #70065017195: Tournament #545010286, $5.00+$0.50 USD Hold'em No Limit - Level VIII (60/120) - 2011/11/05 18:19:08 MSK [2011/11/05 10:19:08 ET]
Table '545010286 77' 9-max Seat #2 is the button
Seat 1: whitepaper38 (5530 in chips) 
Seat 2: Killererin (14952 in chips) 
Seat 3: malik_msk (17355 in chips) 
Seat 4: Dillabeat (5000 in chips) 
Seat 5: kruiiser (3405 in chips) 
Seat 6: popizdiš (4289 in chips) 
Seat 7: Highländer64 (2130 in chips) 
Seat 8: mx.Timo (8676 in chips) 
Seat 9: Pete55558 (12283 in chips) 
whitepaper38: posts the ante 15
Killererin: posts the ante 15
malik_msk: posts the ante 15
Dillabeat: posts the ante 15
kruiiser: posts the ante 15
popizdiš: posts the ante 15
Highländer64: posts the ante 15
mx.Timo: posts the ante 15
Pete55558: posts the ante 15
malik_msk: posts small blind 60
Dillabeat: posts big blind 120
*** HOLE CARDS ***
Dealt to malik_msk [Jh Ts]
kruiiser: folds 
popizdiš: folds 
Highländer64: raises 240 to 360
mx.Timo: folds 
Pete55558: calls 360
whitepaper38: calls 360
Killererin: folds 
malik_msk: folds 
Dillabeat: folds 
*** FLOP *** [Ac 6s Qd]
Highländer64: bets 1755 and is all-in
Pete55558: folds 
whitepaper38: calls 1755
*** TURN *** [Ac 6s Qd] [Kh]
*** RIVER *** [Ac 6s Qd Kh] [Td]
*** SHOW DOWN ***
Highländer64: shows [Tc Th] (three of a kind, Tens)
whitepaper38: shows [Kd Ad] (two pair, Aces and Kings)
Highländer64 collected 4905 from pot
*** SUMMARY ***
Total pot 4905 | Rake 0 
Board [Ac 6s Qd Kh Td]
Seat 1: whitepaper38 showed [Kd Ad] and lost with two pair, Aces and Kings
Seat 2: Killererin (button) folded before Flop (didn't bet)
Seat 3: malik_msk (small blind) folded before Flop
Seat 4: Dillabeat (big blind) folded before Flop
Seat 5: kruiiser folded before Flop (didn't bet)
Seat 6: popizdiš folded before Flop (didn't bet)
Seat 7: Highländer64 showed [Tc Th] and won (4905) with three of a kind, Tens
Seat 8: mx.Timo folded before Flop (didn't bet)
Seat 9: Pete55558 folded on the Flop



PokerStars Game #70065050595: Tournament #545010286, $5.00+$0.50 USD Hold'em No Limit - Level VIII (60/120) - 2011/11/05 18:19:53 MSK [2011/11/05 10:19:53 ET]
Table '545010286 77' 9-max Seat #3 is the button
Seat 1: whitepaper38 (3400 in chips) 
Seat 2: Killererin (14937 in chips) 
Seat 3: malik_msk (17280 in chips) 
Seat 4: Dillabeat (4865 in chips) 
Seat 5: kruiiser (3390 in chips) 
Seat 6: popizdiš (4274 in chips) 
Seat 7: Highländer64 (4905 in chips) 
Seat 8: mx.Timo (8661 in chips) 
Seat 9: Pete55558 (11908 in chips) 
whitepaper38: posts the ante 15
Killererin: posts the ante 15
malik_msk: posts the ante 15
Dillabeat: posts the ante 15
kruiiser: posts the ante 15
popizdiš: posts the ante 15
Highländer64: posts the ante 15
mx.Timo: posts the ante 15
Pete55558: posts the ante 15
Dillabeat: posts small blind 60
kruiiser: posts big blind 120
*** HOLE CARDS ***
Dealt to malik_msk [7c 5c]
popizdiš: folds 
Highländer64: folds 
mx.Timo: folds 
Pete55558: folds 
whitepaper38: folds 
Killererin: folds 
malik_msk: raises 240 to 360
Dillabeat: folds 
kruiiser: folds 
Uncalled bet (240) returned to malik_msk
malik_msk collected 435 from pot
malik_msk: doesn't show hand 
*** SUMMARY ***
Total pot 435 | Rake 0 
Seat 1: whitepaper38 folded before Flop (didn't bet)
Seat 2: Killererin folded before Flop (didn't bet)
Seat 3: malik_msk (button) collected (435)
Seat 4: Dillabeat (small blind) folded before Flop
Seat 5: kruiiser (big blind) folded before Flop
Seat 6: popizdiš folded before Flop (didn't bet)
Seat 7: Highländer64 folded before Flop (didn't bet)
Seat 8: mx.Timo folded before Flop (didn't bet)
Seat 9: Pete55558 folded before Flop (didn't bet)



PokerStars Game #70065077185: Tournament #545010286, $5.00+$0.50 USD Hold'em No Limit - Level VIII (60/120) - 2011/11/05 18:20:29 MSK [2011/11/05 10:20:29 ET]
Table '545010286 77' 9-max Seat #4 is the button
Seat 1: whitepaper38 (3385 in chips) 
Seat 2: Killererin (14922 in chips) 
Seat 3: malik_msk (17580 in chips) 
Seat 4: Dillabeat (4790 in chips) 
Seat 5: kruiiser (3255 in chips) 
Seat 6: popizdiš (4259 in chips) 
Seat 7: Highländer64 (4890 in chips) 
Seat 8: mx.Timo (8646 in chips) 
Seat 9: Pete55558 (11893 in chips) 
whitepaper38: posts the ante 15
Killererin: posts the ante 15
malik_msk: posts the ante 15
Dillabeat: posts the ante 15
kruiiser: posts the ante 15
popizdiš: posts the ante 15
Highländer64: posts the ante 15
mx.Timo: posts the ante 15
Pete55558: posts the ante 15
kruiiser: posts small blind 60
popizdiš: posts big blind 120
*** HOLE CARDS ***
Dealt to malik_msk [7c 6c]
Highländer64: folds 
mx.Timo: folds 
Pete55558: folds 
whitepaper38: folds 
Killererin: folds 
malik_msk: calls 120
Dillabeat: folds 
kruiiser: calls 60
popizdiš: checks 
*** FLOP *** [Qd 8d 8h]
kruiiser: checks 
popizdiš: bets 120
malik_msk: folds 
kruiiser: calls 120
*** TURN *** [Qd 8d 8h] [5c]
kruiiser: checks 
popizdiš: bets 120
kruiiser: raises 240 to 360
popizdiš: folds 
Uncalled bet (240) returned to kruiiser
kruiiser collected 975 from pot
kruiiser: doesn't show hand 
*** SUMMARY ***
Total pot 975 | Rake 0 
Board [Qd 8d 8h 5c]
Seat 1: whitepaper38 folded before Flop (didn't bet)
Seat 2: Killererin folded before Flop (didn't bet)
Seat 3: malik_msk folded on the Flop
Seat 4: Dillabeat (button) folded before Flop (didn't bet)
Seat 5: kruiiser (small blind) collected (975)
Seat 6: popizdiš (big blind) folded on the Turn
Seat 7: Highländer64 folded before Flop (didn't bet)
Seat 8: mx.Timo folded before Flop (didn't bet)
Seat 9: Pete55558 folded before Flop (didn't bet)



PokerStars Game #70065115351: Tournament #545010286, $5.00+$0.50 USD Hold'em No Limit - Level VIII (60/120) - 2011/11/05 18:21:21 MSK [2011/11/05 10:21:21 ET]
Table '545010286 77' 9-max Seat #5 is the button
Seat 1: whitepaper38 (3370 in chips) 
Seat 2: Killererin (14907 in chips) 
Seat 3: malik_msk (17445 in chips) 
Seat 4: Dillabeat (4775 in chips) 
Seat 5: kruiiser (3855 in chips) 
Seat 6: popizdiš (3884 in chips) 
Seat 7: Highländer64 (4875 in chips) 
Seat 8: mx.Timo (8631 in chips) 
Seat 9: Pete55558 (11878 in chips) 
whitepaper38: posts the ante 15
Killererin: posts the ante 15
malik_msk: posts the ante 15
Dillabeat: posts the ante 15
kruiiser: posts the ante 15
popizdiš: posts the ante 15
Highländer64: posts the ante 15
mx.Timo: posts the ante 15
Pete55558: posts the ante 15
popizdiš: posts small blind 60
Highländer64: posts big blind 120
*** HOLE CARDS ***
Dealt to malik_msk [4c 8c]
mx.Timo: folds 
Pete55558: folds 
whitepaper38: folds 
Killererin: raises 240 to 360
malik_msk: folds 
Dillabeat: folds 
kruiiser: folds 
popizdiš: folds 
Highländer64: calls 240
*** FLOP *** [Qd 3d 4h]
Highländer64: bets 600
Killererin: folds 
Uncalled bet (600) returned to Highländer64
Highländer64 collected 915 from pot
*** SUMMARY ***
Total pot 915 | Rake 0 
Board [Qd 3d 4h]
Seat 1: whitepaper38 folded before Flop (didn't bet)
Seat 2: Killererin folded on the Flop
Seat 3: malik_msk folded before Flop (didn't bet)
Seat 4: Dillabeat folded before Flop (didn't bet)
Seat 5: kruiiser (button) folded before Flop (didn't bet)
Seat 6: popizdiš (small blind) folded before Flop
Seat 7: Highländer64 (big blind) collected (915)
Seat 8: mx.Timo folded before Flop (didn't bet)
Seat 9: Pete55558 folded before Flop (didn't bet)



PokerStars Game #70065142179: Tournament #545010286, $5.00+$0.50 USD Hold'em No Limit - Level VIII (60/120) - 2011/11/05 18:21:57 MSK [2011/11/05 10:21:57 ET]
Table '545010286 77' 9-max Seat #6 is the button
Seat 1: whitepaper38 (3355 in chips) 
Seat 2: Killererin (14532 in chips) 
Seat 3: malik_msk (17430 in chips) 
Seat 4: Dillabeat (4760 in chips) 
Seat 5: kruiiser (3840 in chips) 
Seat 6: popizdiš (3809 in chips) 
Seat 7: Highländer64 (5415 in chips) 
Seat 8: mx.Timo (8616 in chips) 
Seat 9: Pete55558 (11863 in chips) 
whitepaper38: posts the ante 15
Killererin: posts the ante 15
malik_msk: posts the ante 15
Dillabeat: posts the ante 15
kruiiser: posts the ante 15
popizdiš: posts the ante 15
Highländer64: posts the ante 15
mx.Timo: posts the ante 15
Pete55558: posts the ante 15
Highländer64: posts small blind 60
mx.Timo: posts big blind 120
*** HOLE CARDS ***
Dealt to malik_msk [Kd Jh]
Pete55558: folds 
whitepaper38: folds 
Killererin: folds 
malik_msk: raises 120 to 240
Dillabeat: folds 
kruiiser: folds 
popizdiš: calls 240
Highländer64: calls 180
mx.Timo: calls 120
*** FLOP *** [5s Qd Th]
Highländer64: checks 
mx.Timo: checks 
malik_msk: checks 
popizdiš: checks 
*** TURN *** [5s Qd Th] [Jc]
Highländer64: checks 
mx.Timo: checks 
malik_msk: checks 
popizdiš: bets 360
Highländer64: folds 
mx.Timo: folds 
malik_msk: calls 360
*** RIVER *** [5s Qd Th Jc] [8s]
malik_msk: checks 
popizdiš: checks 
*** SHOW DOWN ***
malik_msk: shows [Kd Jh] (a pair of Jacks)
popizdiš: mucks hand 
malik_msk collected 1815 from pot
*** SUMMARY ***
Total pot 1815 | Rake 0 
Board [5s Qd Th Jc 8s]
Seat 1: whitepaper38 folded before Flop (didn't bet)
Seat 2: Killererin folded before Flop (didn't bet)
Seat 3: malik_msk showed [Kd Jh] and won (1815) with a pair of Jacks
Seat 4: Dillabeat folded before Flop (didn't bet)
Seat 5: kruiiser folded before Flop (didn't bet)
Seat 6: popizdiš (button) mucked [Ts Kc]
Seat 7: Highländer64 (small blind) folded on the Turn
Seat 8: mx.Timo (big blind) folded on the Turn
Seat 9: Pete55558 folded before Flop (didn't bet)



PokerStars Game #70065187096: Tournament #545010286, $5.00+$0.50 USD Hold'em No Limit - Level VIII (60/120) - 2011/11/05 18:22:59 MSK [2011/11/05 10:22:59 ET]
Table '545010286 77' 9-max Seat #7 is the button
Seat 1: whitepaper38 (3340 in chips) 
Seat 2: Killererin (14517 in chips) 
Seat 3: malik_msk (18630 in chips) 
Seat 4: Dillabeat (4745 in chips) 
Seat 5: kruiiser (3825 in chips) 
Seat 6: popizdiš (3194 in chips) 
Seat 7: Highländer64 (5160 in chips) 
Seat 8: mx.Timo (8361 in chips) 
Seat 9: Pete55558 (11848 in chips) 
whitepaper38: posts the ante 15
Killererin: posts the ante 15
malik_msk: posts the ante 15
Dillabeat: posts the ante 15
kruiiser: posts the ante 15
popizdiš: posts the ante 15
Highländer64: posts the ante 15
mx.Timo: posts the ante 15
Pete55558: posts the ante 15
mx.Timo: posts small blind 60
Pete55558: posts big blind 120
*** HOLE CARDS ***
Dealt to malik_msk [7d Qh]
whitepaper38: folds 
Killererin: folds 
malik_msk: folds 
Dillabeat: folds 
kruiiser: folds 
popizdiš: calls 120
Highländer64: folds 
mx.Timo: calls 60
Pete55558: checks 
*** FLOP *** [4s 6s Ah]
mx.Timo: checks 
Pete55558: checks 
popizdiš: checks 
*** TURN *** [4s 6s Ah] [Ts]
mx.Timo: checks 
Pete55558: checks 
popizdiš: checks 
*** RIVER *** [4s 6s Ah Ts] [Th]
mx.Timo: checks 
Pete55558: checks 
popizdiš: bets 120
mx.Timo: folds 
Pete55558: folds 
Uncalled bet (120) returned to popizdiš
popizdiš collected 495 from pot
*** SUMMARY ***
Total pot 495 | Rake 0 
Board [4s 6s Ah Ts Th]
Seat 1: whitepaper38 folded before Flop (didn't bet)
Seat 2: Killererin folded before Flop (didn't bet)
Seat 3: malik_msk folded before Flop (didn't bet)
Seat 4: Dillabeat folded before Flop (didn't bet)
Seat 5: kruiiser folded before Flop (didn't bet)
Seat 6: popizdiš collected (495)
Seat 7: Highländer64 (button) folded before Flop (didn't bet)
Seat 8: mx.Timo (small blind) folded on the River
Seat 9: Pete55558 (big blind) folded on the River



PokerStars Game #70065234193: Tournament #545010286, $5.00+$0.50 USD Hold'em No Limit - Level VIII (60/120) - 2011/11/05 18:24:03 MSK [2011/11/05 10:24:03 ET]
Table '545010286 77' 9-max Seat #8 is the button
Seat 1: whitepaper38 (3325 in chips) 
Seat 2: Killererin (14502 in chips) 
Seat 3: malik_msk (18615 in chips) 
Seat 4: Dillabeat (4730 in chips) 
Seat 5: kruiiser (3810 in chips) 
Seat 6: popizdiš (3554 in chips) 
Seat 7: Highländer64 (5145 in chips) 
Seat 8: mx.Timo (8226 in chips) 
Seat 9: Pete55558 (11713 in chips) 
whitepaper38: posts the ante 15
Killererin: posts the ante 15
malik_msk: posts the ante 15
Dillabeat: posts the ante 15
kruiiser: posts the ante 15
popizdiš: posts the ante 15
Highländer64: posts the ante 15
mx.Timo: posts the ante 15
Pete55558: posts the ante 15
Pete55558: posts small blind 60
whitepaper38: posts big blind 120
*** HOLE CARDS ***
Dealt to malik_msk [7d 5h]
Killererin: folds 
malik_msk: folds 
Dillabeat: folds 
kruiiser: raises 120 to 240
popizdiš: folds 
Highländer64: folds 
mx.Timo: folds 
Pete55558: calls 180
whitepaper38: folds 
*** FLOP *** [4c 2s 7h]
Pete55558: checks 
kruiiser: checks 
*** TURN *** [4c 2s 7h] [Ad]
Pete55558: bets 120
kruiiser: raises 240 to 360
Pete55558: calls 240
*** RIVER *** [4c 2s 7h Ad] [Th]
Pete55558: checks 
kruiiser: bets 840
Pete55558: folds 
Uncalled bet (840) returned to kruiiser
kruiiser collected 1455 from pot
*** SUMMARY ***
Total pot 1455 | Rake 0 
Board [4c 2s 7h Ad Th]
Seat 1: whitepaper38 (big blind) folded before Flop
Seat 2: Killererin folded before Flop (didn't bet)
Seat 3: malik_msk folded before Flop (didn't bet)
Seat 4: Dillabeat folded before Flop (didn't bet)
Seat 5: kruiiser collected (1455)
Seat 6: popizdiš folded before Flop (didn't bet)
Seat 7: Highländer64 folded before Flop (didn't bet)
Seat 8: mx.Timo (button) folded before Flop (didn't bet)
Seat 9: Pete55558 (small blind) folded on the River



PokerStars Game #70065278580: Tournament #545010286, $5.00+$0.50 USD Hold'em No Limit - Level VIII (60/120) - 2011/11/05 18:25:04 MSK [2011/11/05 10:25:04 ET]
Table '545010286 77' 9-max Seat #9 is the button
Seat 1: whitepaper38 (3190 in chips) 
Seat 2: Killererin (14487 in chips) 
Seat 3: malik_msk (18600 in chips) 
Seat 4: Dillabeat (4715 in chips) 
Seat 5: kruiiser (4650 in chips) 
Seat 6: popizdiš (3539 in chips) 
Seat 7: Highländer64 (5130 in chips) 
Seat 8: mx.Timo (8211 in chips) 
Seat 9: Pete55558 (11098 in chips) 
whitepaper38: posts the ante 15
Killererin: posts the ante 15
malik_msk: posts the ante 15
Dillabeat: posts the ante 15
kruiiser: posts the ante 15
popizdiš: posts the ante 15
Highländer64: posts the ante 15
mx.Timo: posts the ante 15
Pete55558: posts the ante 15
whitepaper38: posts small blind 60
Killererin: posts big blind 120
*** HOLE CARDS ***
Dealt to malik_msk [Jc 8c]
malik_msk: calls 120
Dillabeat: folds 
kruiiser: folds 
popizdiš: folds 
Highländer64: raises 240 to 360
mx.Timo: folds 
Pete55558: folds 
whitepaper38: folds 
Killererin: folds 
malik_msk: calls 240
*** FLOP *** [9h Js 5d]
malik_msk: bets 840
Highländer64: folds 
Uncalled bet (840) returned to malik_msk
malik_msk collected 1035 from pot
malik_msk: doesn't show hand 
*** SUMMARY ***
Total pot 1035 | Rake 0 
Board [9h Js 5d]
Seat 1: whitepaper38 (small blind) folded before Flop
Seat 2: Killererin (big blind) folded before Flop
Seat 3: malik_msk collected (1035)
Seat 4: Dillabeat folded before Flop (didn't bet)
Seat 5: kruiiser folded before Flop (didn't bet)
Seat 6: popizdiš folded before Flop (didn't bet)
Seat 7: Highländer64 folded on the Flop
Seat 8: mx.Timo folded before Flop (didn't bet)
Seat 9: Pete55558 (button) folded before Flop (didn't bet)



PokerStars Game #70065336437: Tournament #545010286, $5.00+$0.50 USD Hold'em No Limit - Level VIII (60/120) - 2011/11/05 18:26:24 MSK [2011/11/05 10:26:24 ET]
Table '545010286 77' 9-max Seat #1 is the button
Seat 1: whitepaper38 (3115 in chips) 
Seat 2: Killererin (14352 in chips) 
Seat 3: malik_msk (19260 in chips) 
Seat 4: Dillabeat (4700 in chips) 
Seat 5: kruiiser (4635 in chips) 
Seat 6: popizdiš (3524 in chips) 
Seat 7: Highländer64 (4755 in chips) 
Seat 8: mx.Timo (8196 in chips) 
Seat 9: Pete55558 (11083 in chips) 
whitepaper38: posts the ante 15
Killererin: posts the ante 15
malik_msk: posts the ante 15
Dillabeat: posts the ante 15
kruiiser: posts the ante 15
popizdiš: posts the ante 15
Highländer64: posts the ante 15
mx.Timo: posts the ante 15
Pete55558: posts the ante 15
Killererin: posts small blind 60
malik_msk: posts big blind 120
*** HOLE CARDS ***
Dealt to malik_msk [Ts Qs]
Dillabeat: folds 
kruiiser: folds 
popizdiš: calls 120
Highländer64: folds 
mx.Timo: folds 
Pete55558: calls 120
whitepaper38: folds 
Killererin: calls 60
malik_msk: checks 
*** FLOP *** [3c Tc 4h]
Killererin: checks 
malik_msk: bets 120
popizdiš: raises 3269 to 3389 and is all-in
Pete55558: folds 
Killererin: folds 
malik_msk: calls 3269
*** TURN *** [3c Tc 4h] [Td]
*** RIVER *** [3c Tc 4h Td] [7h]
*** SHOW DOWN ***
malik_msk: shows [Ts Qs] (three of a kind, Tens)
popizdiš: shows [Kc Ks] (two pair, Kings and Tens)
malik_msk collected 7393 from pot
popizdiš finished the tournament in 2157th place
*** SUMMARY ***
Total pot 7393 | Rake 0 
Board [3c Tc 4h Td 7h]
Seat 1: whitepaper38 (button) folded before Flop (didn't bet)
Seat 2: Killererin (small blind) folded on the Flop
Seat 3: malik_msk (big blind) showed [Ts Qs] and won (7393) with three of a kind, Tens
Seat 4: Dillabeat folded before Flop (didn't bet)
Seat 5: kruiiser folded before Flop (didn't bet)
Seat 6: popizdiš showed [Kc Ks] and lost with two pair, Kings and Tens
Seat 7: Highländer64 folded before Flop (didn't bet)
Seat 8: mx.Timo folded before Flop (didn't bet)
Seat 9: Pete55558 folded on the Flop



PokerStars Game #70065418116: Tournament #545010286, $5.00+$0.50 USD Hold'em No Limit - Level IX (75/150) - 2011/11/05 18:28:16 MSK [2011/11/05 10:28:16 ET]
Table '545010286 77' 9-max Seat #2 is the button
Seat 1: whitepaper38 (3100 in chips) 
Seat 2: Killererin (14217 in chips) 
Seat 3: malik_msk (23129 in chips) 
Seat 4: Dillabeat (4685 in chips) 
Seat 5: kruiiser (4620 in chips) 
Seat 7: Highländer64 (4740 in chips) 
Seat 8: mx.Timo (8181 in chips) 
Seat 9: Pete55558 (10948 in chips) 
whitepaper38: posts the ante 20
Killererin: posts the ante 20
malik_msk: posts the ante 20
Dillabeat: posts the ante 20
kruiiser: posts the ante 20
Highländer64: posts the ante 20
mx.Timo: posts the ante 20
Pete55558: posts the ante 20
malik_msk: posts small blind 75
Dillabeat: posts big blind 150
*** HOLE CARDS ***
Dealt to malik_msk [4s Qc]
kruiiser: folds 
Highländer64: folds 
baloobaloo00 is connected 
mx.Timo: raises 225 to 375
Pete55558: calls 375
whitepaper38: folds 
Killererin: calls 375
malik_msk: folds 
Dillabeat: folds 
*** FLOP *** [Jd 9h Ts]
mx.Timo: checks 
Pete55558: checks 
Killererin: bets 750
mx.Timo: folds 
Pete55558: calls 750
*** TURN *** [Jd 9h Ts] [3h]
Pete55558: checks 
Killererin: checks 
*** RIVER *** [Jd 9h Ts 3h] [9d]
Pete55558: bets 3010
Killererin: calls 3010
*** SHOW DOWN ***
Pete55558: shows [9s 9c] (four of a kind, Nines)
Killererin: mucks hand 
Pete55558 collected 9030 from pot
*** SUMMARY ***
Total pot 9030 | Rake 0 
Board [Jd 9h Ts 3h 9d]
Seat 1: whitepaper38 folded before Flop (didn't bet)
Seat 2: Killererin (button) mucked [Jh Qh]
Seat 3: malik_msk (small blind) folded before Flop
Seat 4: Dillabeat (big blind) folded before Flop
Seat 5: kruiiser folded before Flop (didn't bet)
Seat 7: Highländer64 folded before Flop (didn't bet)
Seat 8: mx.Timo folded on the Flop
Seat 9: Pete55558 showed [9s 9c] and won (9030) with four of a kind, Nines



PokerStars Game #70065485315: Tournament #545010286, $5.00+$0.50 USD Hold'em No Limit - Level IX (75/150) - 2011/11/05 18:29:49 MSK [2011/11/05 10:29:49 ET]
Table '545010286 77' 9-max Seat #3 is the button
Seat 1: whitepaper38 (3080 in chips) 
Seat 2: Killererin (10062 in chips) 
Seat 3: malik_msk (23034 in chips) 
Seat 4: Dillabeat (4515 in chips) 
Seat 5: kruiiser (4600 in chips) 
Seat 6: baloobaloo00 (8141 in chips) 
Seat 7: Highländer64 (4720 in chips) 
Seat 8: mx.Timo (7786 in chips) 
Seat 9: Pete55558 (15823 in chips) 
whitepaper38: posts the ante 20
Killererin: posts the ante 20
malik_msk: posts the ante 20
Dillabeat: posts the ante 20
kruiiser: posts the ante 20
baloobaloo00: posts the ante 20
Highländer64: posts the ante 20
mx.Timo: posts the ante 20
Pete55558: posts the ante 20
Dillabeat: posts small blind 75
kruiiser: posts big blind 150
*** HOLE CARDS ***
Dealt to malik_msk [4c Ac]
baloobaloo00: folds 
Highländer64: folds 
mx.Timo: folds 
Pete55558: folds 
whitepaper38: folds 
Killererin: folds 
malik_msk: raises 150 to 300
Dillabeat: folds 
kruiiser: folds 
Uncalled bet (150) returned to malik_msk
malik_msk collected 555 from pot
malik_msk: doesn't show hand 
*** SUMMARY ***
Total pot 555 | Rake 0 
Seat 1: whitepaper38 folded before Flop (didn't bet)
Seat 2: Killererin folded before Flop (didn't bet)
Seat 3: malik_msk (button) collected (555)
Seat 4: Dillabeat (small blind) folded before Flop
Seat 5: kruiiser (big blind) folded before Flop
Seat 6: baloobaloo00 folded before Flop (didn't bet)
Seat 7: Highländer64 folded before Flop (didn't bet)
Seat 8: mx.Timo folded before Flop (didn't bet)
Seat 9: Pete55558 folded before Flop (didn't bet)



PokerStars Game #70065504251: Tournament #545010286, $5.00+$0.50 USD Hold'em No Limit - Level IX (75/150) - 2011/11/05 18:30:15 MSK [2011/11/05 10:30:15 ET]
Table '545010286 77' 9-max Seat #4 is the button
Seat 1: whitepaper38 (3060 in chips) 
Seat 2: Killererin (10042 in chips) 
Seat 3: malik_msk (23419 in chips) 
Seat 4: Dillabeat (4420 in chips) 
Seat 5: kruiiser (4430 in chips) 
Seat 6: baloobaloo00 (8121 in chips) 
Seat 7: Highländer64 (4700 in chips) 
Seat 8: mx.Timo (7766 in chips) 
Seat 9: Pete55558 (15803 in chips) 
whitepaper38: posts the ante 20
Killererin: posts the ante 20
malik_msk: posts the ante 20
Dillabeat: posts the ante 20
kruiiser: posts the ante 20
baloobaloo00: posts the ante 20
Highländer64: posts the ante 20
mx.Timo: posts the ante 20
Pete55558: posts the ante 20
kruiiser: posts small blind 75
baloobaloo00: posts big blind 150
*** HOLE CARDS ***
Dealt to malik_msk [Ac Ah]
Highländer64: calls 150
mx.Timo: raises 600 to 750
Pete55558: folds 
whitepaper38: folds 
Killererin: folds 
malik_msk: raises 750 to 1500
Dillabeat: folds 
kruiiser: folds 
baloobaloo00: folds 
Highländer64: raises 3180 to 4680 and is all-in
mx.Timo: raises 3066 to 7746 and is all-in
malik_msk: calls 6246
*** FLOP *** [Ks Ts 2s]
*** TURN *** [Ks Ts 2s] [4d]
*** RIVER *** [Ks Ts 2s 4d] [7c]
*** SHOW DOWN ***
mx.Timo: shows [Ad Kh] (a pair of Kings)
malik_msk: shows [Ac Ah] (a pair of Aces)
malik_msk collected 6132 from side pot
Highländer64: shows [Jc Jh] (a pair of Jacks)
malik_msk collected 14445 from main pot
mx.Timo finished the tournament in 2042nd place
Highländer64 finished the tournament in 2043rd place
flouschen is connected 
*** SUMMARY ***
Total pot 20577 Main pot 14445. Side pot 6132. | Rake 0 
Board [Ks Ts 2s 4d 7c]
Seat 1: whitepaper38 folded before Flop (didn't bet)
Seat 2: Killererin folded before Flop (didn't bet)
Seat 3: malik_msk showed [Ac Ah] and won (20577) with a pair of Aces
Seat 4: Dillabeat (button) folded before Flop (didn't bet)
Seat 5: kruiiser (small blind) folded before Flop
Seat 6: baloobaloo00 (big blind) folded before Flop
Seat 7: Highländer64 showed [Jc Jh] and lost with a pair of Jacks
Seat 8: mx.Timo showed [Ad Kh] and lost with a pair of Kings
Seat 9: Pete55558 folded before Flop (didn't bet)



PokerStars Game #70065555471: Tournament #545010286, $5.00+$0.50 USD Hold'em No Limit - Level IX (75/150) - 2011/11/05 18:31:26 MSK [2011/11/05 10:31:26 ET]
Table '545010286 77' 9-max Seat #5 is the button
Seat 1: whitepaper38 (3040 in chips) 
Seat 2: Killererin (10022 in chips) 
Seat 3: malik_msk (36230 in chips) 
Seat 4: Dillabeat (4400 in chips) 
Seat 5: kruiiser (4335 in chips) 
Seat 6: baloobaloo00 (7951 in chips) 
Seat 8: flouschen (6972 in chips) 
Seat 9: Pete55558 (15783 in chips) 
whitepaper38: posts the ante 20
Killererin: posts the ante 20
malik_msk: posts the ante 20
Dillabeat: posts the ante 20
kruiiser: posts the ante 20
baloobaloo00: posts the ante 20
flouschen: posts the ante 20
Pete55558: posts the ante 20
baloobaloo00: posts small blind 75
flouschen: posts big blind 150
*** HOLE CARDS ***
Dealt to malik_msk [Ts 7s]
Pete55558: raises 150 to 300
whitepaper38: folds 
Killererin: folds 
malik_msk: folds 
skarga3434 is connected 
Dillabeat: folds 
kruiiser: folds 
baloobaloo00: folds 
flouschen: calls 150
*** FLOP *** [Ad As Jd]
flouschen: checks 
Pete55558: bets 150
flouschen: folds 
Uncalled bet (150) returned to Pete55558
Pete55558 collected 835 from pot
Pete55558: doesn't show hand 
*** SUMMARY ***
Total pot 835 | Rake 0 
Board [Ad As Jd]
Seat 1: whitepaper38 folded before Flop (didn't bet)
Seat 2: Killererin folded before Flop (didn't bet)
Seat 3: malik_msk folded before Flop (didn't bet)
Seat 4: Dillabeat folded before Flop (didn't bet)
Seat 5: kruiiser (button) folded before Flop (didn't bet)
Seat 6: baloobaloo00 (small blind) folded before Flop
Seat 8: flouschen (big blind) folded on the Flop
Seat 9: Pete55558 collected (835)



PokerStars Game #70065583896: Tournament #545010286, $5.00+$0.50 USD Hold'em No Limit - Level IX (75/150) - 2011/11/05 18:32:05 MSK [2011/11/05 10:32:05 ET]
Table '545010286 77' 9-max Seat #6 is the button
Seat 1: whitepaper38 (3020 in chips) 
Seat 2: Killererin (10002 in chips) 
Seat 3: malik_msk (36210 in chips) 
Seat 4: Dillabeat (4380 in chips) 
Seat 5: kruiiser (4315 in chips) 
Seat 6: baloobaloo00 (7856 in chips) 
Seat 7: skarga3434 (2883 in chips) out of hand (moved from another table into small blind)
Seat 8: flouschen (6652 in chips) 
Seat 9: Pete55558 (16298 in chips) 
whitepaper38: posts the ante 20
Killererin: posts the ante 20
malik_msk: posts the ante 20
Dillabeat: posts the ante 20
kruiiser: posts the ante 20
baloobaloo00: posts the ante 20
flouschen: posts the ante 20
Pete55558: posts the ante 20
flouschen: posts small blind 75
Pete55558: posts big blind 150
*** HOLE CARDS ***
Dealt to malik_msk [Qd 4d]
whitepaper38: folds 
Killererin: folds 
malik_msk: folds 
Dillabeat: raises 202 to 352
kruiiser: raises 248 to 600
baloobaloo00: folds 
flouschen: folds 
flouschen is sitting out
Pete55558: folds 
Dillabeat: raises 606 to 1206
kruiiser: raises 3089 to 4295 and is all-in
Dillabeat: calls 3089
*** FLOP *** [Qs 9h Ks]
malik_msk said, "lol"
*** TURN *** [Qs 9h Ks] [2s]
*** RIVER *** [Qs 9h Ks 2s] [8c]
*** SHOW DOWN ***
Dillabeat: shows [Ad Ah] (a pair of Aces)
kruiiser: shows [As Ac] (a pair of Aces)
Dillabeat collected 4488 from pot
kruiiser collected 4487 from pot
*** SUMMARY ***
Total pot 8975 | Rake 0 
Board [Qs 9h Ks 2s 8c]
Seat 1: whitepaper38 folded before Flop (didn't bet)
Seat 2: Killererin folded before Flop (didn't bet)
Seat 3: malik_msk folded before Flop (didn't bet)
Seat 4: Dillabeat showed [Ad Ah] and won (4488) with a pair of Aces
Seat 5: kruiiser showed [As Ac] and won (4487) with a pair of Aces
Seat 6: baloobaloo00 (button) folded before Flop (didn't bet)
Seat 8: flouschen (small blind) folded before Flop
Seat 9: Pete55558 (big blind) folded before Flop



PokerStars Game #70065642477: Tournament #545010286, $5.00+$0.50 USD Hold'em No Limit - Level IX (75/150) - 2011/11/05 18:33:26 MSK [2011/11/05 10:33:26 ET]
Table '545010286 77' 9-max Seat #8 is the button
Seat 1: whitepaper38 (3000 in chips) 
Seat 2: Killererin (9982 in chips) 
Seat 3: malik_msk (36190 in chips) 
Seat 4: Dillabeat (4553 in chips) 
Seat 5: kruiiser (4487 in chips) 
Seat 6: baloobaloo00 (7836 in chips) 
Seat 7: skarga3434 (2883 in chips) 
Seat 8: flouschen (6557 in chips) is sitting out
Seat 9: Pete55558 (16128 in chips) 
whitepaper38: posts the ante 20
Killererin: posts the ante 20
malik_msk: posts the ante 20
Dillabeat: posts the ante 20
kruiiser: posts the ante 20
baloobaloo00: posts the ante 20
skarga3434: posts the ante 20
flouschen: posts the ante 20
Pete55558: posts the ante 20
Pete55558: posts small blind 75
whitepaper38: posts big blind 150
*** HOLE CARDS ***
Dealt to malik_msk [6d 4h]
Killererin: folds 
malik_msk: folds 
Dillabeat: folds 
kruiiser: folds 
baloobaloo00: folds 
skarga3434: folds 
flouschen: folds 
Pete55558: folds 
Uncalled bet (75) returned to whitepaper38
whitepaper38 collected 330 from pot
*** SUMMARY ***
Total pot 330 | Rake 0 
Seat 1: whitepaper38 (big blind) collected (330)
Seat 2: Killererin folded before Flop (didn't bet)
Seat 3: malik_msk folded before Flop (didn't bet)
Seat 4: Dillabeat folded before Flop (didn't bet)
Seat 5: kruiiser folded before Flop (didn't bet)
Seat 6: baloobaloo00 folded before Flop (didn't bet)
Seat 7: skarga3434 folded before Flop (didn't bet)
Seat 8: flouschen (button) folded before Flop (didn't bet)
Seat 9: Pete55558 (small blind) folded before Flop



PokerStars Game #70065653144: Tournament #545010286, $5.00+$0.50 USD Hold'em No Limit - Level IX (75/150) - 2011/11/05 18:33:41 MSK [2011/11/05 10:33:41 ET]
Table '545010286 77' 9-max Seat #9 is the button
Seat 1: whitepaper38 (3235 in chips) 
Seat 2: Killererin (9962 in chips) 
Seat 3: malik_msk (36170 in chips) 
Seat 4: Dillabeat (4533 in chips) 
Seat 5: kruiiser (4467 in chips) 
Seat 6: baloobaloo00 (7816 in chips) 
Seat 7: skarga3434 (2863 in chips) 
Seat 8: flouschen (6537 in chips) is sitting out
Seat 9: Pete55558 (16033 in chips) 
whitepaper38: posts the ante 20
Killererin: posts the ante 20
malik_msk: posts the ante 20
Dillabeat: posts the ante 20
kruiiser: posts the ante 20
baloobaloo00: posts the ante 20
skarga3434: posts the ante 20
flouschen: posts the ante 20
Pete55558: posts the ante 20
whitepaper38: posts small blind 75
Killererin: posts big blind 150
*** HOLE CARDS ***
Dealt to malik_msk [Jc 2s]
malik_msk: folds 
Dillabeat: folds 
kruiiser: raises 225 to 375
baloobaloo00: folds 
skarga3434: folds 
flouschen: folds 
Pete55558: calls 375
whitepaper38: calls 300
Killererin: folds 
*** FLOP *** [4s Jh 2d]
whitepaper38: checks 
kruiiser: bets 600
Pete55558: folds 
whitepaper38: calls 600
*** TURN *** [4s Jh 2d] [Ac]
whitepaper38: checks 
kruiiser: bets 1050
whitepaper38: calls 1050
*** RIVER *** [4s Jh 2d Ac] [7h]
whitepaper38: bets 1190 and is all-in
kruiiser: calls 1190
*** SHOW DOWN ***
whitepaper38: shows [Ts Js] (a pair of Jacks)
kruiiser: shows [Kd Kc] (a pair of Kings)
kruiiser collected 7135 from pot
whitepaper38 finished the tournament in 1940th place
*** SUMMARY ***
Total pot 7135 | Rake 0 
Board [4s Jh 2d Ac 7h]
Seat 1: whitepaper38 (small blind) showed [Ts Js] and lost with a pair of Jacks
Seat 2: Killererin (big blind) folded before Flop
Seat 3: malik_msk folded before Flop (didn't bet)
Seat 4: Dillabeat folded before Flop (didn't bet)
Seat 5: kruiiser showed [Kd Kc] and won (7135) with a pair of Kings
Seat 6: baloobaloo00 folded before Flop (didn't bet)
Seat 7: skarga3434 folded before Flop (didn't bet)
Seat 8: flouschen folded before Flop (didn't bet)
Seat 9: Pete55558 (button) folded on the Flop



PokerStars Game #70065705276: Tournament #545010286, $5.00+$0.50 USD Hold'em No Limit - Level IX (75/150) - 2011/11/05 18:34:53 MSK [2011/11/05 10:34:53 ET]
Table '545010286 77' 9-max Seat #2 is the button
Seat 2: Killererin (9792 in chips) 
Seat 3: malik_msk (36150 in chips) 
Seat 4: Dillabeat (4513 in chips) 
Seat 5: kruiiser (8367 in chips) 
Seat 6: baloobaloo00 (7796 in chips) 
Seat 7: skarga3434 (2843 in chips) 
Seat 8: flouschen (6517 in chips) is sitting out
Seat 9: Pete55558 (15638 in chips) 
Killererin: posts the ante 20
malik_msk: posts the ante 20
Dillabeat: posts the ante 20
kruiiser: posts the ante 20
baloobaloo00: posts the ante 20
skarga3434: posts the ante 20
flouschen: posts the ante 20
Pete55558: posts the ante 20
malik_msk: posts small blind 75
Dillabeat: posts big blind 150
*** HOLE CARDS ***
Dealt to malik_msk [7h Ah]
Piton131313 is connected 
kruiiser: folds 
baloobaloo00: raises 300 to 450
skarga3434: folds 
flouschen: folds 
Pete55558: folds 
Killererin: folds 
malik_msk: calls 375
flouschen has returned
Dillabeat: folds 
*** FLOP *** [8s Th Qs]
malik_msk: checks 
baloobaloo00: bets 450
malik_msk: folds 
Uncalled bet (450) returned to baloobaloo00
baloobaloo00 collected 1210 from pot
baloobaloo00: doesn't show hand 
*** SUMMARY ***
Total pot 1210 | Rake 0 
Board [8s Th Qs]
Seat 2: Killererin (button) folded before Flop (didn't bet)
Seat 3: malik_msk (small blind) folded on the Flop
Seat 4: Dillabeat (big blind) folded before Flop
Seat 5: kruiiser folded before Flop (didn't bet)
Seat 6: baloobaloo00 collected (1210)
Seat 7: skarga3434 folded before Flop (didn't bet)
Seat 8: flouschen folded before Flop (didn't bet)
Seat 9: Pete55558 folded before Flop (didn't bet)



PokerStars Game #70065755374: Tournament #545010286, $5.00+$0.50 USD Hold'em No Limit - Level IX (75/150) - 2011/11/05 18:36:03 MSK [2011/11/05 10:36:03 ET]
Table '545010286 77' 9-max Seat #3 is the button
Seat 1: Piton131313 (15494 in chips) 
Seat 2: Killererin (9772 in chips) 
Seat 3: malik_msk (35680 in chips) 
Seat 4: Dillabeat (4343 in chips) 
Seat 5: kruiiser (8347 in chips) 
Seat 6: baloobaloo00 (8536 in chips) 
Seat 7: skarga3434 (2823 in chips) 
Seat 8: flouschen (6497 in chips) 
Seat 9: Pete55558 (15618 in chips) 
Piton131313: posts the ante 20
Killererin: posts the ante 20
malik_msk: posts the ante 20
Dillabeat: posts the ante 20
kruiiser: posts the ante 20
baloobaloo00: posts the ante 20
skarga3434: posts the ante 20
flouschen: posts the ante 20
Pete55558: posts the ante 20
Dillabeat: posts small blind 75
kruiiser: posts big blind 150
*** HOLE CARDS ***
Dealt to malik_msk [9s Ac]
baloobaloo00: folds 
skarga3434: folds 
flouschen: raises 300 to 450
Pete55558: folds 
Piton131313: folds 
Killererin: folds 
malik_msk: folds 
Dillabeat: folds 
kruiiser: folds 
Uncalled bet (300) returned to flouschen
flouschen collected 555 from pot
flouschen: doesn't show hand 
*** SUMMARY ***
Total pot 555 | Rake 0 
Seat 1: Piton131313 folded before Flop (didn't bet)
Seat 2: Killererin folded before Flop (didn't bet)
Seat 3: malik_msk (button) folded before Flop (didn't bet)
Seat 4: Dillabeat (small blind) folded before Flop
Seat 5: kruiiser (big blind) folded before Flop
Seat 6: baloobaloo00 folded before Flop (didn't bet)
Seat 7: skarga3434 folded before Flop (didn't bet)
Seat 8: flouschen collected (555)
Seat 9: Pete55558 folded before Flop (didn't bet)



PokerStars Game #70065773522: Tournament #545010286, $5.00+$0.50 USD Hold'em No Limit - Level IX (75/150) - 2011/11/05 18:36:28 MSK [2011/11/05 10:36:28 ET]
Table '545010286 77' 9-max Seat #4 is the button
Seat 1: Piton131313 (15474 in chips) 
Seat 2: Killererin (9752 in chips) 
Seat 3: malik_msk (35660 in chips) 
Seat 4: Dillabeat (4248 in chips) 
Seat 5: kruiiser (8177 in chips) 
Seat 6: baloobaloo00 (8516 in chips) 
Seat 7: skarga3434 (2803 in chips) 
Seat 8: flouschen (6882 in chips) 
Seat 9: Pete55558 (15598 in chips) 
Piton131313: posts the ante 20
Killererin: posts the ante 20
malik_msk: posts the ante 20
Dillabeat: posts the ante 20
kruiiser: posts the ante 20
baloobaloo00: posts the ante 20
skarga3434: posts the ante 20
flouschen: posts the ante 20
Pete55558: posts the ante 20
kruiiser: posts small blind 75
baloobaloo00: posts big blind 150
*** HOLE CARDS ***
Dealt to malik_msk [8h Td]
skarga3434: folds 
flouschen: calls 150
Pete55558: calls 150
Piton131313: calls 150
Killererin: calls 150
malik_msk: calls 150
Dillabeat: folds 
kruiiser: calls 75
baloobaloo00: checks 
*** FLOP *** [7s Ac 5h]
kruiiser: checks 
baloobaloo00: checks 
flouschen: bets 300
Pete55558: folds 
Piton131313: calls 300
Killererin: calls 300
malik_msk: folds 
kruiiser: folds 
baloobaloo00: folds 
*** TURN *** [7s Ac 5h] [3h]
flouschen: bets 450
Piton131313: raises 600 to 1050
Killererin: folds 
flouschen: calls 600
*** RIVER *** [7s Ac 5h 3h] [4h]
flouschen: bets 5362 and is all-in
Piton131313: calls 5362
*** SHOW DOWN ***
flouschen: shows [3c 4c] (two pair, Fours and Threes)
Piton131313: shows [Ah Ts] (a pair of Aces)
flouschen collected 14954 from pot
*** SUMMARY ***
Total pot 14954 | Rake 0 
Board [7s Ac 5h 3h 4h]
Seat 1: Piton131313 showed [Ah Ts] and lost with a pair of Aces
Seat 2: Killererin folded on the Turn
Seat 3: malik_msk folded on the Flop
Seat 4: Dillabeat (button) folded before Flop (didn't bet)
Seat 5: kruiiser (small blind) folded on the Flop
Seat 6: baloobaloo00 (big blind) folded on the Flop
Seat 7: skarga3434 folded before Flop (didn't bet)
Seat 8: flouschen showed [3c 4c] and won (14954) with two pair, Fours and Threes
Seat 9: Pete55558 folded on the Flop



PokerStars Game #70065863688: Tournament #545010286, $5.00+$0.50 USD Hold'em No Limit - Level X (100/200) - 2011/11/05 18:38:33 MSK [2011/11/05 10:38:33 ET]
Table '545010286 77' 9-max Seat #5 is the button
Seat 1: Piton131313 (8592 in chips) 
Seat 2: Killererin (9282 in chips) 
Seat 3: malik_msk (35490 in chips) 
Seat 4: Dillabeat (4228 in chips) 
Seat 5: kruiiser (8007 in chips) 
Seat 6: baloobaloo00 (8346 in chips) 
Seat 7: skarga3434 (2783 in chips) 
Seat 8: flouschen (14954 in chips) 
Seat 9: Pete55558 (15428 in chips) 
Piton131313: posts the ante 25
Killererin: posts the ante 25
malik_msk: posts the ante 25
Dillabeat: posts the ante 25
kruiiser: posts the ante 25
baloobaloo00: posts the ante 25
skarga3434: posts the ante 25
flouschen: posts the ante 25
Pete55558: posts the ante 25
baloobaloo00: posts small blind 100
skarga3434: posts big blind 200
*** HOLE CARDS ***
Dealt to malik_msk [Jc 9d]
flouschen: calls 200
Pete55558: calls 200
Piton131313: calls 200
Killererin: raises 800 to 1000
malik_msk: folds 
Dillabeat: folds 
kruiiser: folds 
baloobaloo00: folds 
skarga3434: folds 
flouschen: calls 800
Pete55558: folds 
Piton131313: calls 800
*** FLOP *** [4h 7c Td]
flouschen: bets 200
Piton131313: calls 200
Killererin: raises 1600 to 1800
flouschen: calls 1600
Piton131313: folds 
*** TURN *** [4h 7c Td] [Qh]
flouschen: bets 600
Killererin: raises 2200 to 2800
flouschen: folds 
Uncalled bet (2200) returned to Killererin
Killererin collected 8725 from pot
Killererin: doesn't show hand 
*** SUMMARY ***
Total pot 8725 | Rake 0 
Board [4h 7c Td Qh]
Seat 1: Piton131313 folded on the Flop
Seat 2: Killererin collected (8725)
Seat 3: malik_msk folded before Flop (didn't bet)
Seat 4: Dillabeat folded before Flop (didn't bet)
Seat 5: kruiiser (button) folded before Flop (didn't bet)
Seat 6: baloobaloo00 (small blind) folded before Flop
Seat 7: skarga3434 (big blind) folded before Flop
Seat 8: flouschen folded on the Turn
Seat 9: Pete55558 folded before Flop



PokerStars Game #70065930476: Tournament #545010286, $5.00+$0.50 USD Hold'em No Limit - Level X (100/200) - 2011/11/05 18:40:07 MSK [2011/11/05 10:40:07 ET]
Table '545010286 77' 9-max Seat #6 is the button
Seat 1: Piton131313 (7367 in chips) 
Seat 2: Killererin (14582 in chips) 
Seat 3: malik_msk (35465 in chips) 
Seat 4: Dillabeat (4203 in chips) 
Seat 5: kruiiser (7982 in chips) 
Seat 6: baloobaloo00 (8221 in chips) 
Seat 7: skarga3434 (2558 in chips) 
Seat 8: flouschen (11529 in chips) 
Seat 9: Pete55558 (15203 in chips) 
Piton131313: posts the ante 25
Killererin: posts the ante 25
malik_msk: posts the ante 25
Dillabeat: posts the ante 25
kruiiser: posts the ante 25
baloobaloo00: posts the ante 25
skarga3434: posts the ante 25
flouschen: posts the ante 25
Pete55558: posts the ante 25
skarga3434: posts small blind 100
flouschen: posts big blind 200
*** HOLE CARDS ***
Dealt to malik_msk [Kd 5h]
Pete55558: folds 
Piton131313: folds 
Killererin: folds 
malik_msk: folds 
Dillabeat: folds 
kruiiser: raises 268 to 468
baloobaloo00: folds 
skarga3434: calls 368
flouschen: calls 268
*** FLOP *** [Ah Qc 3c]
skarga3434: checks 
flouschen: bets 1000
malik_msk is sitting out
kruiiser: folds 
skarga3434: folds 
Uncalled bet (1000) returned to flouschen
flouschen collected 1629 from pot
flouschen: doesn't show hand 
*** SUMMARY ***
Total pot 1629 | Rake 0 
Board [Ah Qc 3c]
Seat 1: Piton131313 folded before Flop (didn't bet)
Seat 2: Killererin folded before Flop (didn't bet)
Seat 3: malik_msk folded before Flop (didn't bet)
Seat 4: Dillabeat folded before Flop (didn't bet)
Seat 5: kruiiser folded on the Flop
Seat 6: baloobaloo00 (button) folded before Flop (didn't bet)
Seat 7: skarga3434 (small blind) folded on the Flop
Seat 8: flouschen (big blind) collected (1629)
Seat 9: Pete55558 folded before Flop (didn't bet)



PokerStars Game #70065957693: Tournament #545010286, $5.00+$0.50 USD Hold'em No Limit - Level X (100/200) - 2011/11/05 18:40:45 MSK [2011/11/05 10:40:45 ET]
Table '545010286 77' 9-max Seat #7 is the button
Seat 1: Piton131313 (7342 in chips) 
Seat 2: Killererin (14557 in chips) 
Seat 3: malik_msk (35440 in chips) is sitting out
Seat 4: Dillabeat (4178 in chips) 
Seat 5: kruiiser (7489 in chips) 
Seat 6: baloobaloo00 (8196 in chips) 
Seat 7: skarga3434 (2065 in chips) 
Seat 8: flouschen (12665 in chips) 
Seat 9: Pete55558 (15178 in chips) 
Piton131313: posts the ante 25
Killererin: posts the ante 25
malik_msk: posts the ante 25
Dillabeat: posts the ante 25
kruiiser: posts the ante 25
baloobaloo00: posts the ante 25
skarga3434: posts the ante 25
flouschen: posts the ante 25
Pete55558: posts the ante 25
flouschen: posts small blind 100
Pete55558: posts big blind 200
*** HOLE CARDS ***
Dealt to malik_msk [Qh Kh]
Piton131313: folds 
malik_msk has returned
Killererin: folds 
malik_msk: raises 200 to 400
Dillabeat: folds 
kruiiser: raises 600 to 1000
baloobaloo00: folds 
skarga3434: folds 
flouschen: raises 11640 to 12640 and is all-in
Pete55558: folds 
malik_msk: folds 
kruiiser: folds 
Uncalled bet (11640) returned to flouschen
flouschen collected 2825 from pot
*** SUMMARY ***
Total pot 2825 | Rake 0 
Seat 1: Piton131313 folded before Flop (didn't bet)
Seat 2: Killererin folded before Flop (didn't bet)
Seat 3: malik_msk folded before Flop
Seat 4: Dillabeat folded before Flop (didn't bet)
Seat 5: kruiiser folded before Flop
Seat 6: baloobaloo00 folded before Flop (didn't bet)
Seat 7: skarga3434 (button) folded before Flop (didn't bet)
Seat 8: flouschen (small blind) collected (2825)
Seat 9: Pete55558 (big blind) folded before Flop



PokerStars Game #70065987010: Tournament #545010286, $5.00+$0.50 USD Hold'em No Limit - Level X (100/200) - 2011/11/05 18:41:26 MSK [2011/11/05 10:41:26 ET]
Table '545010286 77' 9-max Seat #8 is the button
Seat 1: Piton131313 (7317 in chips) 
Seat 2: Killererin (14532 in chips) 
Seat 3: malik_msk (35015 in chips) 
Seat 4: Dillabeat (4153 in chips) 
Seat 5: kruiiser (6464 in chips) 
Seat 6: baloobaloo00 (8171 in chips) 
Seat 7: skarga3434 (2040 in chips) 
Seat 8: flouschen (14465 in chips) 
Seat 9: Pete55558 (14953 in chips) 
Piton131313: posts the ante 25
Killererin: posts the ante 25
malik_msk: posts the ante 25
Dillabeat: posts the ante 25
kruiiser: posts the ante 25
baloobaloo00: posts the ante 25
skarga3434: posts the ante 25
flouschen: posts the ante 25
Pete55558: posts the ante 25
Pete55558: posts small blind 100
Piton131313: posts big blind 200
*** HOLE CARDS ***
Dealt to malik_msk [9d 6c]
Killererin: raises 400 to 600
malik_msk: folds 
malik_msk is sitting out
Dillabeat: folds 
kruiiser: folds 
baloobaloo00: folds 
skarga3434: folds 
flouschen: calls 600
Pete55558: calls 500
Piton131313: folds 
*** FLOP *** [Kd Jc 3h]
Pete55558: checks 
Killererin: bets 800
flouschen: raises 800 to 1600
Pete55558: folds 
Killererin: calls 800
*** TURN *** [Kd Jc 3h] [4c]
Killererin: checks 
flouschen: bets 1000
Killererin: raises 2200 to 3200
flouschen: raises 9040 to 12240 and is all-in
Killererin: calls 9040
*** RIVER *** [Kd Jc 3h 4c] [4h]
*** SHOW DOWN ***
Killererin: shows [Kh As] (two pair, Kings and Fours)
flouschen: shows [Qd Th] (a pair of Fours)
Killererin collected 29905 from pot
flouschen finished the tournament in 1688th place
*** SUMMARY ***
Total pot 29905 | Rake 0 
Board [Kd Jc 3h 4c 4h]
Seat 1: Piton131313 (big blind) folded before Flop
Seat 2: Killererin showed [Kh As] and won (29905) with two pair, Kings and Fours
Seat 3: malik_msk folded before Flop (didn't bet)
Seat 4: Dillabeat folded before Flop (didn't bet)
Seat 5: kruiiser folded before Flop (didn't bet)
Seat 6: baloobaloo00 folded before Flop (didn't bet)
Seat 7: skarga3434 folded before Flop (didn't bet)
Seat 8: flouschen (button) showed [Qd Th] and lost with a pair of Fours
Seat 9: Pete55558 (small blind) folded on the Flop



PokerStars Game #70066037875: Tournament #545010286, $5.00+$0.50 USD Hold'em No Limit - Level X (100/200) - 2011/11/05 18:42:36 MSK [2011/11/05 10:42:36 ET]
Table '545010286 77' 9-max Seat #9 is the button
Seat 1: Piton131313 (7092 in chips) 
Seat 2: Killererin (29972 in chips) 
Seat 3: malik_msk (34990 in chips) is sitting out
Seat 4: Dillabeat (4128 in chips) 
Seat 5: kruiiser (6439 in chips) 
Seat 6: baloobaloo00 (8146 in chips) 
Seat 7: skarga3434 (2015 in chips) 
Seat 9: Pete55558 (14328 in chips) 
Piton131313: posts the ante 25
Killererin: posts the ante 25
malik_msk: posts the ante 25
Dillabeat: posts the ante 25
kruiiser: posts the ante 25
baloobaloo00: posts the ante 25
skarga3434: posts the ante 25
Pete55558: posts the ante 25
Piton131313: posts small blind 100
Killererin: posts big blind 200
*** HOLE CARDS ***
Dealt to malik_msk [5d 6h]
malik_msk: folds 
malik_msk has returned
Dillabeat: folds 
tetraodon86 is connected 
kruiiser: folds 
baloobaloo00: folds 
skarga3434: folds 
Pete55558: raises 300 to 500
Piton131313: folds 
Killererin: folds 
Uncalled bet (300) returned to Pete55558
Pete55558 collected 700 from pot
Pete55558: doesn't show hand 
*** SUMMARY ***
Total pot 700 | Rake 0 
Seat 1: Piton131313 (small blind) folded before Flop
Seat 2: Killererin (big blind) folded before Flop
Seat 3: malik_msk folded before Flop (didn't bet)
Seat 4: Dillabeat folded before Flop (didn't bet)
Seat 5: kruiiser folded before Flop (didn't bet)
Seat 6: baloobaloo00 folded before Flop (didn't bet)
Seat 7: skarga3434 folded before Flop (didn't bet)
Seat 9: Pete55558 (button) collected (700)



PokerStars Game #70066065591: Tournament #545010286, $5.00+$0.50 USD Hold'em No Limit - Level X (100/200) - 2011/11/05 18:43:15 MSK [2011/11/05 10:43:15 ET]
Table '545010286 77' 9-max Seat #1 is the button
Seat 1: Piton131313 (6967 in chips) 
Seat 2: Killererin (29747 in chips) 
Seat 3: malik_msk (34965 in chips) 
Seat 4: Dillabeat (4103 in chips) 
Seat 5: kruiiser (6414 in chips) 
Seat 6: baloobaloo00 (8121 in chips) 
Seat 7: skarga3434 (1990 in chips) 
Seat 8: tetraodon86 (5357 in chips) 
Seat 9: Pete55558 (14803 in chips) 
Piton131313: posts the ante 25
Killererin: posts the ante 25
malik_msk: posts the ante 25
Dillabeat: posts the ante 25
kruiiser: posts the ante 25
baloobaloo00: posts the ante 25
skarga3434: posts the ante 25
tetraodon86: posts the ante 25
Pete55558: posts the ante 25
Killererin: posts small blind 100
malik_msk: posts big blind 200
*** HOLE CARDS ***
Dealt to malik_msk [2c 4h]
Dillabeat: folds 
kruiiser: folds 
baloobaloo00: folds 
skarga3434: folds 
malik_msk said, "uznai russkogo po avataru"
tetraodon86 has timed out
tetraodon86: folds 
tetraodon86 is sitting out
Pete55558: folds 
Piton131313: folds 
Killererin: folds 
Uncalled bet (100) returned to malik_msk
malik_msk collected 425 from pot
malik_msk: doesn't show hand 
*** SUMMARY ***
Total pot 425 | Rake 0 
Seat 1: Piton131313 (button) folded before Flop (didn't bet)
Seat 2: Killererin (small blind) folded before Flop
Seat 3: malik_msk (big blind) collected (425)
Seat 4: Dillabeat folded before Flop (didn't bet)
Seat 5: kruiiser folded before Flop (didn't bet)
Seat 6: baloobaloo00 folded before Flop (didn't bet)
Seat 7: skarga3434 folded before Flop (didn't bet)
Seat 8: tetraodon86 folded before Flop (didn't bet)
Seat 9: Pete55558 folded before Flop (didn't bet)



PokerStars Game #70066089658: Tournament #545010286, $5.00+$0.50 USD Hold'em No Limit - Level X (100/200) - 2011/11/05 18:43:48 MSK [2011/11/05 10:43:48 ET]
Table '545010286 77' 9-max Seat #2 is the button
Seat 1: Piton131313 (6942 in chips) 
Seat 2: Killererin (29622 in chips) 
Seat 3: malik_msk (35265 in chips) 
Seat 4: Dillabeat (4078 in chips) 
Seat 5: kruiiser (6389 in chips) 
Seat 6: baloobaloo00 (8096 in chips) 
Seat 7: skarga3434 (1965 in chips) 
Seat 8: tetraodon86 (5332 in chips) is sitting out
Seat 9: Pete55558 (14778 in chips) 
Piton131313: posts the ante 25
Killererin: posts the ante 25
malik_msk: posts the ante 25
Dillabeat: posts the ante 25
kruiiser: posts the ante 25
baloobaloo00: posts the ante 25
skarga3434: posts the ante 25
tetraodon86: posts the ante 25
Pete55558: posts the ante 25
malik_msk: posts small blind 100
Dillabeat: posts big blind 200
*** HOLE CARDS ***
Dealt to malik_msk [Qh 2d]
kruiiser: folds 
baloobaloo00: folds 
skarga3434: raises 600 to 800
tetraodon86: folds 
Pete55558: folds 
Piton131313: folds 
Killererin: folds 
malik_msk: folds 
Dillabeat: folds 
Uncalled bet (600) returned to skarga3434
skarga3434 collected 725 from pot
skarga3434: doesn't show hand 
*** SUMMARY ***
Total pot 725 | Rake 0 
Seat 1: Piton131313 folded before Flop (didn't bet)
Seat 2: Killererin (button) folded before Flop (didn't bet)
Seat 3: malik_msk (small blind) folded before Flop
Seat 4: Dillabeat (big blind) folded before Flop
Seat 5: kruiiser folded before Flop (didn't bet)
Seat 6: baloobaloo00 folded before Flop (didn't bet)
Seat 7: skarga3434 collected (725)
Seat 8: tetraodon86 folded before Flop (didn't bet)
Seat 9: Pete55558 folded before Flop (didn't bet)



PokerStars Game #70066112416: Tournament #545010286, $5.00+$0.50 USD Hold'em No Limit - Level X (100/200) - 2011/11/05 18:44:19 MSK [2011/11/05 10:44:19 ET]
Table '545010286 77' 9-max Seat #3 is the button
Seat 1: Piton131313 (6917 in chips) 
Seat 2: Killererin (29597 in chips) 
Seat 3: malik_msk (35140 in chips) 
Seat 4: Dillabeat (3853 in chips) 
Seat 5: kruiiser (6364 in chips) 
Seat 6: baloobaloo00 (8071 in chips) 
Seat 7: skarga3434 (2465 in chips) 
Seat 8: tetraodon86 (5307 in chips) is sitting out
Seat 9: Pete55558 (14753 in chips) 
Piton131313: posts the ante 25
Killererin: posts the ante 25
malik_msk: posts the ante 25
Dillabeat: posts the ante 25
kruiiser: posts the ante 25
baloobaloo00: posts the ante 25
skarga3434: posts the ante 25
tetraodon86: posts the ante 25
Pete55558: posts the ante 25
Dillabeat: posts small blind 100
kruiiser: posts big blind 200
*** HOLE CARDS ***
Dealt to malik_msk [6h Js]
baloobaloo00: folds 
skarga3434: folds 
tetraodon86: folds 
Pete55558: raises 300 to 500
Piton131313: raises 700 to 1200
Killererin: folds 
malik_msk: folds 
Dillabeat: folds 
kruiiser: folds 
Pete55558: calls 700
*** FLOP *** [Ac 8s 5c]
Pete55558: checks 
Piton131313: checks 
*** TURN *** [Ac 8s 5c] [7d]
Pete55558: checks 
Piton131313: bets 1700
Pete55558: calls 1700
*** RIVER *** [Ac 8s 5c 7d] [Jd]
Pete55558: checks 
Piton131313: bets 3992 and is all-in
Pete55558: folds 
Uncalled bet (3992) returned to Piton131313
Piton131313 collected 6325 from pot
*** SUMMARY ***
Total pot 6325 | Rake 0 
Board [Ac 8s 5c 7d Jd]
Seat 1: Piton131313 collected (6325)
Seat 2: Killererin folded before Flop (didn't bet)
Seat 3: malik_msk (button) folded before Flop (didn't bet)
Seat 4: Dillabeat (small blind) folded before Flop
Seat 5: kruiiser (big blind) folded before Flop
Seat 6: baloobaloo00 folded before Flop (didn't bet)
Seat 7: skarga3434 folded before Flop (didn't bet)
Seat 8: tetraodon86 folded before Flop (didn't bet)
Seat 9: Pete55558 folded on the River



PokerStars Game #70066173918: Tournament #545010286, $5.00+$0.50 USD Hold'em No Limit - Level X (100/200) - 2011/11/05 18:45:44 MSK [2011/11/05 10:45:44 ET]
Table '545010286 77' 9-max Seat #4 is the button
Seat 1: Piton131313 (10317 in chips) 
Seat 2: Killererin (29572 in chips) 
Seat 3: malik_msk (35115 in chips) 
Seat 4: Dillabeat (3728 in chips) 
Seat 5: kruiiser (6139 in chips) 
Seat 6: baloobaloo00 (8046 in chips) 
Seat 7: skarga3434 (2440 in chips) 
Seat 8: tetraodon86 (5282 in chips) is sitting out
Seat 9: Pete55558 (11828 in chips) 
Piton131313: posts the ante 25
Killererin: posts the ante 25
malik_msk: posts the ante 25
Dillabeat: posts the ante 25
kruiiser: posts the ante 25
baloobaloo00: posts the ante 25
skarga3434: posts the ante 25
tetraodon86: posts the ante 25
Pete55558: posts the ante 25
kruiiser: posts small blind 100
baloobaloo00: posts big blind 200
*** HOLE CARDS ***
Dealt to malik_msk [As 2s]
skarga3434: folds 
tetraodon86: folds 
Pete55558: folds 
Piton131313: folds 
Killererin: raises 200 to 400
malik_msk: calls 400
Dillabeat: folds 
kruiiser: raises 1000 to 1400
baloobaloo00: raises 1600 to 3000
Killererin: folds 
malik_msk: folds 
kruiiser: folds 
Uncalled bet (1600) returned to baloobaloo00
baloobaloo00 collected 3825 from pot
baloobaloo00: doesn't show hand 
*** SUMMARY ***
Total pot 3825 | Rake 0 
Seat 1: Piton131313 folded before Flop (didn't bet)
Seat 2: Killererin folded before Flop
Seat 3: malik_msk folded before Flop
Seat 4: Dillabeat (button) folded before Flop (didn't bet)
Seat 5: kruiiser (small blind) folded before Flop
Seat 6: baloobaloo00 (big blind) collected (3825)
Seat 7: skarga3434 folded before Flop (didn't bet)
Seat 8: tetraodon86 folded before Flop (didn't bet)
Seat 9: Pete55558 folded before Flop (didn't bet)



PokerStars Game #70066212077: Tournament #545010286, $5.00+$0.50 USD Hold'em No Limit - Level X (100/200) - 2011/11/05 18:46:36 MSK [2011/11/05 10:46:36 ET]
Table '545010286 77' 9-max Seat #5 is the button
Seat 1: Piton131313 (10292 in chips) 
Seat 2: Killererin (29147 in chips) 
Seat 3: malik_msk (34690 in chips) 
Seat 4: Dillabeat (3703 in chips) 
Seat 5: kruiiser (4714 in chips) 
Seat 6: baloobaloo00 (10446 in chips) 
Seat 7: skarga3434 (2415 in chips) 
Seat 8: tetraodon86 (5257 in chips) is sitting out
Seat 9: Pete55558 (11803 in chips) 
Piton131313: posts the ante 25
Killererin: posts the ante 25
malik_msk: posts the ante 25
Dillabeat: posts the ante 25
kruiiser: posts the ante 25
baloobaloo00: posts the ante 25
skarga3434: posts the ante 25
tetraodon86: posts the ante 25
Pete55558: posts the ante 25
baloobaloo00: posts small blind 100
skarga3434: posts big blind 200
*** HOLE CARDS ***
Dealt to malik_msk [5h Kd]
tetraodon86: folds 
Pete55558: folds 
Piton131313: folds 
Killererin: raises 200 to 400
malik_msk: folds 
Dillabeat: raises 3278 to 3678 and is all-in
kruiiser: folds 
baloobaloo00: folds 
skarga3434: folds 
Killererin: calls 3278
*** FLOP *** [Jh 9s 5c]
*** TURN *** [Jh 9s 5c] [3h]
*** RIVER *** [Jh 9s 5c 3h] [8d]
*** SHOW DOWN ***
Killererin: shows [Qh Ah] (high card Ace)
Dillabeat: shows [Qc Kh] (high card King)
Killererin collected 7881 from pot
Dillabeat finished the tournament in 1577th place
*** SUMMARY ***
Total pot 7881 | Rake 0 
Board [Jh 9s 5c 3h 8d]
Seat 1: Piton131313 folded before Flop (didn't bet)
Seat 2: Killererin showed [Qh Ah] and won (7881) with high card Ace
Seat 3: malik_msk folded before Flop (didn't bet)
Seat 4: Dillabeat showed [Qc Kh] and lost with high card King
Seat 5: kruiiser (button) folded before Flop (didn't bet)
Seat 6: baloobaloo00 (small blind) folded before Flop
Seat 7: skarga3434 (big blind) folded before Flop
Seat 8: tetraodon86 folded before Flop (didn't bet)
Seat 9: Pete55558 folded before Flop (didn't bet)



PokerStars Game #70066248675: Tournament #545010286, $5.00+$0.50 USD Hold'em No Limit - Level X (100/200) - 2011/11/05 18:47:27 MSK [2011/11/05 10:47:27 ET]
Table '545010286 77' 9-max Seat #6 is the button
Seat 1: Piton131313 (10267 in chips) 
Seat 2: Killererin (33325 in chips) 
Seat 3: malik_msk (34665 in chips) 
Seat 5: kruiiser (4689 in chips) 
Seat 6: baloobaloo00 (10321 in chips) 
Seat 7: skarga3434 (2190 in chips) 
Seat 8: tetraodon86 (5232 in chips) is sitting out
Seat 9: Pete55558 (11778 in chips) 
Piton131313: posts the ante 25
Killererin: posts the ante 25
malik_msk: posts the ante 25
kruiiser: posts the ante 25
baloobaloo00: posts the ante 25
skarga3434: posts the ante 25
tetraodon86: posts the ante 25
Pete55558: posts the ante 25
skarga3434: posts small blind 100
tetraodon86: posts big blind 200
*** HOLE CARDS ***
Dealt to malik_msk [4d 8c]
Pete55558: folds 
baztack is connected 
Piton131313: folds 
Killererin: folds 
malik_msk: folds 
kruiiser: raises 300 to 500
baloobaloo00: folds 
skarga3434: calls 400
tetraodon86: folds 
*** FLOP *** [As 8d 3s]
skarga3434: checks 
kruiiser: checks 
*** TURN *** [As 8d 3s] [5s]
skarga3434: checks 
kruiiser: bets 600
skarga3434: calls 600
*** RIVER *** [As 8d 3s 5s] [5c]
skarga3434: checks 
kruiiser: checks 
*** SHOW DOWN ***
skarga3434: shows [Tc Ks] (a pair of Fives)
kruiiser: shows [6s 6h] (two pair, Sixes and Fives)
kruiiser collected 2600 from pot
*** SUMMARY ***
Total pot 2600 | Rake 0 
Board [As 8d 3s 5s 5c]
Seat 1: Piton131313 folded before Flop (didn't bet)
Seat 2: Killererin folded before Flop (didn't bet)
Seat 3: malik_msk folded before Flop (didn't bet)
Seat 5: kruiiser showed [6s 6h] and won (2600) with two pair, Sixes and Fives
Seat 6: baloobaloo00 (button) folded before Flop (didn't bet)
Seat 7: skarga3434 (small blind) showed [Tc Ks] and lost with a pair of Fives
Seat 8: tetraodon86 (big blind) folded before Flop
Seat 9: Pete55558 folded before Flop (didn't bet)



PokerStars Game #70066279506: Tournament #545010286, $5.00+$0.50 USD Hold'em No Limit - Level XI (125/250) - 2011/11/05 18:48:09 MSK [2011/11/05 10:48:09 ET]
Table '545010286 77' 9-max Seat #7 is the button
Seat 1: Piton131313 (10242 in chips) 
Seat 2: Killererin (33300 in chips) 
Seat 3: malik_msk (34640 in chips) 
Seat 4: baztack (11345 in chips) 
Seat 5: kruiiser (6164 in chips) 
Seat 6: baloobaloo00 (10296 in chips) 
Seat 7: skarga3434 (1065 in chips) 
Seat 8: tetraodon86 (5007 in chips) is sitting out
Seat 9: Pete55558 (11753 in chips) 
Piton131313: posts the ante 30
Killererin: posts the ante 30
malik_msk: posts the ante 30
baztack: posts the ante 30
kruiiser: posts the ante 30
baloobaloo00: posts the ante 30
skarga3434: posts the ante 30
tetraodon86: posts the ante 30
Pete55558: posts the ante 30
tetraodon86: posts small blind 125
Pete55558: posts big blind 250
*** HOLE CARDS ***
Dealt to malik_msk [5d Th]
Piton131313: raises 425 to 675
Killererin: folds 
malik_msk: folds 
baztack: folds 
kruiiser: folds 
baloobaloo00: folds 
skarga3434: folds 
tetraodon86: folds 
Pete55558: folds 
Uncalled bet (425) returned to Piton131313
Piton131313 collected 895 from pot
*** SUMMARY ***
Total pot 895 | Rake 0 
Seat 1: Piton131313 collected (895)
Seat 2: Killererin folded before Flop (didn't bet)
Seat 3: malik_msk folded before Flop (didn't bet)
Seat 4: baztack folded before Flop (didn't bet)
Seat 5: kruiiser folded before Flop (didn't bet)
Seat 6: baloobaloo00 folded before Flop (didn't bet)
Seat 7: skarga3434 (button) folded before Flop (didn't bet)
Seat 8: tetraodon86 (small blind) folded before Flop
Seat 9: Pete55558 (big blind) folded before Flop



PokerStars Game #70066295295: Tournament #545010286, $5.00+$0.50 USD Hold'em No Limit - Level XI (125/250) - 2011/11/05 18:48:31 MSK [2011/11/05 10:48:31 ET]
Table '545010286 77' 9-max Seat #8 is the button
Seat 1: Piton131313 (10857 in chips) 
Seat 2: Killererin (33270 in chips) 
Seat 3: malik_msk (34610 in chips) 
Seat 4: baztack (11315 in chips) 
Seat 5: kruiiser (6134 in chips) 
Seat 6: baloobaloo00 (10266 in chips) 
Seat 7: skarga3434 (1035 in chips) 
Seat 8: tetraodon86 (4852 in chips) is sitting out
Seat 9: Pete55558 (11473 in chips) 
Piton131313: posts the ante 30
Killererin: posts the ante 30
malik_msk: posts the ante 30
baztack: posts the ante 30
kruiiser: posts the ante 30
baloobaloo00: posts the ante 30
skarga3434: posts the ante 30
tetraodon86: posts the ante 30
Pete55558: posts the ante 30
Pete55558: posts small blind 125
Piton131313: posts big blind 250
*** HOLE CARDS ***
Dealt to malik_msk [As 3d]
Killererin: folds 
malik_msk: folds 
baztack: folds 
kruiiser: folds 
baloobaloo00: folds 
skarga3434: folds 
tetraodon86: folds 
Pete55558: folds 
Uncalled bet (125) returned to Piton131313
Piton131313 collected 520 from pot
*** SUMMARY ***
Total pot 520 | Rake 0 
Seat 1: Piton131313 (big blind) collected (520)
Seat 2: Killererin folded before Flop (didn't bet)
Seat 3: malik_msk folded before Flop (didn't bet)
Seat 4: baztack folded before Flop (didn't bet)
Seat 5: kruiiser folded before Flop (didn't bet)
Seat 6: baloobaloo00 folded before Flop (didn't bet)
Seat 7: skarga3434 folded before Flop (didn't bet)
Seat 8: tetraodon86 (button) folded before Flop (didn't bet)
Seat 9: Pete55558 (small blind) folded before Flop



PokerStars Game #70066309380: Tournament #545010286, $5.00+$0.50 USD Hold'em No Limit - Level XI (125/250) - 2011/11/05 18:48:50 MSK [2011/11/05 10:48:50 ET]
Table '545010286 77' 9-max Seat #9 is the button
Seat 1: Piton131313 (11222 in chips) 
Seat 2: Killererin (33240 in chips) 
Seat 3: malik_msk (34580 in chips) 
Seat 4: baztack (11285 in chips) 
Seat 5: kruiiser (6104 in chips) 
Seat 6: baloobaloo00 (10236 in chips) 
Seat 7: skarga3434 (1005 in chips) 
Seat 8: tetraodon86 (4822 in chips) is sitting out
Seat 9: Pete55558 (11318 in chips) 
Piton131313: posts the ante 30
Killererin: posts the ante 30
malik_msk: posts the ante 30
baztack: posts the ante 30
kruiiser: posts the ante 30
baloobaloo00: posts the ante 30
skarga3434: posts the ante 30
tetraodon86: posts the ante 30
Pete55558: posts the ante 30
Piton131313: posts small blind 125
Killererin: posts big blind 250
*** HOLE CARDS ***
Dealt to malik_msk [Th 6c]
malik_msk: folds 
baztack: folds 
kruiiser: folds 
baloobaloo00: folds 
skarga3434: raises 725 to 975 and is all-in
tetraodon86: folds 
Pete55558: folds 
Piton131313: folds 
Killererin: calls 725
*** FLOP *** [3c 7c 8h]
*** TURN *** [3c 7c 8h] [Ad]
*** RIVER *** [3c 7c 8h Ad] [2d]
*** SHOW DOWN ***
Killererin: shows [7h Ah] (two pair, Aces and Sevens)
skarga3434: shows [Kd Kc] (a pair of Kings)
Killererin collected 2345 from pot
skarga3434 finished the tournament in 1532nd place
*** SUMMARY ***
Total pot 2345 | Rake 0 
Board [3c 7c 8h Ad 2d]
Seat 1: Piton131313 (small blind) folded before Flop
Seat 2: Killererin (big blind) showed [7h Ah] and won (2345) with two pair, Aces and Sevens
Seat 3: malik_msk folded before Flop (didn't bet)
Seat 4: baztack folded before Flop (didn't bet)
Seat 5: kruiiser folded before Flop (didn't bet)
Seat 6: baloobaloo00 folded before Flop (didn't bet)
Seat 7: skarga3434 showed [Kd Kc] and lost with a pair of Kings
Seat 8: tetraodon86 folded before Flop (didn't bet)
Seat 9: Pete55558 (button) folded before Flop (didn't bet)



PokerStars Game #70066338126: Tournament #545010286, $5.00+$0.50 USD Hold'em No Limit - Level XI (125/250) - 2011/11/05 18:49:30 MSK [2011/11/05 10:49:30 ET]
Table '545010286 77' 9-max Seat #1 is the button
Seat 1: Piton131313 (11067 in chips) 
Seat 2: Killererin (34580 in chips) 
Seat 3: malik_msk (34550 in chips) 
Seat 4: baztack (11255 in chips) 
Seat 5: kruiiser (6074 in chips) 
Seat 6: baloobaloo00 (10206 in chips) 
Seat 7: allanshrek01 (5761 in chips) 
Seat 8: tetraodon86 (4792 in chips) is sitting out
Seat 9: Pete55558 (11288 in chips) 
Piton131313: posts the ante 30
Killererin: posts the ante 30
malik_msk: posts the ante 30
baztack: posts the ante 30
kruiiser: posts the ante 30
baloobaloo00: posts the ante 30
allanshrek01: posts the ante 30
tetraodon86: posts the ante 30
Pete55558: posts the ante 30
Killererin: posts small blind 125
malik_msk: posts big blind 250
*** HOLE CARDS ***
Dealt to malik_msk [Jh 2d]
baztack: folds 
kruiiser: folds 
baloobaloo00: folds 
allanshrek01: folds 
tetraodon86: folds 
Pete55558: folds 
Piton131313: folds 
Killererin: calls 125
malik_msk: checks 
*** FLOP *** [3h Ad 6s]
Killererin: bets 250
malik_msk: folds 
Uncalled bet (250) returned to Killererin
Killererin collected 770 from pot
Killererin: doesn't show hand 
*** SUMMARY ***
Total pot 770 | Rake 0 
Board [3h Ad 6s]
Seat 1: Piton131313 (button) folded before Flop (didn't bet)
Seat 2: Killererin (small blind) collected (770)
Seat 3: malik_msk (big blind) folded on the Flop
Seat 4: baztack folded before Flop (didn't bet)
Seat 5: kruiiser folded before Flop (didn't bet)
Seat 6: baloobaloo00 folded before Flop (didn't bet)
Seat 7: allanshrek01 folded before Flop (didn't bet)
Seat 8: tetraodon86 folded before Flop (didn't bet)
Seat 9: Pete55558 folded before Flop (didn't bet)



PokerStars Game #70066357116: Tournament #545010286, $5.00+$0.50 USD Hold'em No Limit - Level XI (125/250) - 2011/11/05 18:49:56 MSK [2011/11/05 10:49:56 ET]
Table '545010286 77' 9-max Seat #2 is the button
Seat 1: Piton131313 (11037 in chips) 
Seat 2: Killererin (35070 in chips) 
Seat 3: malik_msk (34270 in chips) 
Seat 4: baztack (11225 in chips) 
Seat 5: kruiiser (6044 in chips) 
Seat 6: baloobaloo00 (10176 in chips) 
Seat 7: allanshrek01 (5731 in chips) 
Seat 8: tetraodon86 (4762 in chips) is sitting out
Seat 9: Pete55558 (11258 in chips) 
Piton131313: posts the ante 30
Killererin: posts the ante 30
malik_msk: posts the ante 30
baztack: posts the ante 30
kruiiser: posts the ante 30
baloobaloo00: posts the ante 30
allanshrek01: posts the ante 30
tetraodon86: posts the ante 30
Pete55558: posts the ante 30
malik_msk: posts small blind 125
baztack: posts big blind 250
*** HOLE CARDS ***
Dealt to malik_msk [4s 6d]
kruiiser: folds 
tetraodon86 has returned
baloobaloo00: folds 
allanshrek01 is connected 
allanshrek01: folds 
tetraodon86: folds 
Pete55558: raises 375 to 625
Piton131313: folds 
Killererin: folds 
malik_msk: calls 500
baztack: folds 
*** FLOP *** [Ks Ah 8d]
malik_msk: checks 
Pete55558: checks 
*** TURN *** [Ks Ah 8d] [Qd]
malik_msk: bets 1000
Pete55558: folds 
Uncalled bet (1000) returned to malik_msk
malik_msk collected 1770 from pot
malik_msk: doesn't show hand 
*** SUMMARY ***
Total pot 1770 | Rake 0 
Board [Ks Ah 8d Qd]
Seat 1: Piton131313 folded before Flop (didn't bet)
Seat 2: Killererin (button) folded before Flop (didn't bet)
Seat 3: malik_msk (small blind) collected (1770)
Seat 4: baztack (big blind) folded before Flop
Seat 5: kruiiser folded before Flop (didn't bet)
Seat 6: baloobaloo00 folded before Flop (didn't bet)
Seat 7: allanshrek01 folded before Flop (didn't bet)
Seat 8: tetraodon86 folded before Flop (didn't bet)
Seat 9: Pete55558 folded on the Turn



PokerStars Game #70066409205: Tournament #545010286, $5.00+$0.50 USD Hold'em No Limit - Level XI (125/250) - 2011/11/05 18:51:07 MSK [2011/11/05 10:51:07 ET]
Table '545010286 77' 9-max Seat #3 is the button
Seat 1: Piton131313 (11007 in chips) 
Seat 2: Killererin (35040 in chips) 
Seat 3: malik_msk (35385 in chips) 
Seat 4: baztack (10945 in chips) 
Seat 5: kruiiser (6014 in chips) 
Seat 6: baloobaloo00 (10146 in chips) 
Seat 7: allanshrek01 (5701 in chips) 
Seat 8: tetraodon86 (4732 in chips) 
Seat 9: Pete55558 (10603 in chips) 
Piton131313: posts the ante 30
Killererin: posts the ante 30
malik_msk: posts the ante 30
baztack: posts the ante 30
kruiiser: posts the ante 30
baloobaloo00: posts the ante 30
allanshrek01: posts the ante 30
tetraodon86: posts the ante 30
Pete55558: posts the ante 30
baztack: posts small blind 125
kruiiser: posts big blind 250
*** HOLE CARDS ***
Dealt to malik_msk [6s 4d]
baloobaloo00: folds 
allanshrek01: folds 
tetraodon86: folds 
Pete55558: folds 
Piton131313: folds 
Killererin: raises 250 to 500
malik_msk: folds 
baztack: folds 
kruiiser: raises 5484 to 5984 and is all-in
Killererin: folds 
Uncalled bet (5484) returned to kruiiser
kruiiser collected 1395 from pot
*** SUMMARY ***
Total pot 1395 | Rake 0 
Seat 1: Piton131313 folded before Flop (didn't bet)
Seat 2: Killererin folded before Flop
Seat 3: malik_msk (button) folded before Flop (didn't bet)
Seat 4: baztack (small blind) folded before Flop
Seat 5: kruiiser (big blind) collected (1395)
Seat 6: baloobaloo00 folded before Flop (didn't bet)
Seat 7: allanshrek01 folded before Flop (didn't bet)
Seat 8: tetraodon86 folded before Flop (didn't bet)
Seat 9: Pete55558 folded before Flop (didn't bet)



PokerStars Game #70066434968: Tournament #545010286, $5.00+$0.50 USD Hold'em No Limit - Level XI (125/250) - 2011/11/05 18:51:43 MSK [2011/11/05 10:51:43 ET]
Table '545010286 77' 9-max Seat #4 is the button
Seat 1: Piton131313 (10977 in chips) 
Seat 2: Killererin (34510 in chips) 
Seat 3: malik_msk (35355 in chips) 
Seat 4: baztack (10790 in chips) 
Seat 5: kruiiser (6879 in chips) 
Seat 6: baloobaloo00 (10116 in chips) 
Seat 7: allanshrek01 (5671 in chips) 
Seat 8: tetraodon86 (4702 in chips) 
Seat 9: Pete55558 (10573 in chips) 
Piton131313: posts the ante 30
Killererin: posts the ante 30
malik_msk: posts the ante 30
baztack: posts the ante 30
kruiiser: posts the ante 30
baloobaloo00: posts the ante 30
allanshrek01: posts the ante 30
tetraodon86: posts the ante 30
Pete55558: posts the ante 30
kruiiser: posts small blind 125
baloobaloo00: posts big blind 250
*** HOLE CARDS ***
Dealt to malik_msk [3s 2d]
allanshrek01: calls 250
tetraodon86: raises 500 to 750
Pete55558: folds 
Piton131313: folds 
Killererin: folds 
malik_msk: folds 
baztack: folds 
kruiiser: folds 
baloobaloo00: folds 
allanshrek01: calls 500
*** FLOP *** [8d 7h Ad]
allanshrek01: bets 750
tetraodon86: raises 3172 to 3922 and is all-in
allanshrek01: folds 
Uncalled bet (3172) returned to tetraodon86
tetraodon86 collected 3645 from pot
tetraodon86: doesn't show hand 
*** SUMMARY ***
Total pot 3645 | Rake 0 
Board [8d 7h Ad]
Seat 1: Piton131313 folded before Flop (didn't bet)
Seat 2: Killererin folded before Flop (didn't bet)
Seat 3: malik_msk folded before Flop (didn't bet)
Seat 4: baztack (button) folded before Flop (didn't bet)
Seat 5: kruiiser (small blind) folded before Flop
Seat 6: baloobaloo00 (big blind) folded before Flop
Seat 7: allanshrek01 folded on the Flop
Seat 8: tetraodon86 collected (3645)
Seat 9: Pete55558 folded before Flop (didn't bet)



PokerStars Game #70066457089: Tournament #545010286, $5.00+$0.50 USD Hold'em No Limit - Level XI (125/250) - 2011/11/05 18:52:13 MSK [2011/11/05 10:52:13 ET]
Table '545010286 77' 9-max Seat #5 is the button
Seat 1: Piton131313 (10947 in chips) 
Seat 2: Killererin (34480 in chips) 
Seat 3: malik_msk (35325 in chips) 
Seat 4: baztack (10760 in chips) 
Seat 5: kruiiser (6724 in chips) 
Seat 6: baloobaloo00 (9836 in chips) 
Seat 7: allanshrek01 (4141 in chips) 
Seat 8: tetraodon86 (6817 in chips) 
Seat 9: Pete55558 (10543 in chips) 
Piton131313: posts the ante 30
Killererin: posts the ante 30
malik_msk: posts the ante 30
baztack: posts the ante 30
kruiiser: posts the ante 30
baloobaloo00: posts the ante 30
allanshrek01: posts the ante 30
tetraodon86: posts the ante 30
Pete55558: posts the ante 30
baloobaloo00: posts small blind 125
allanshrek01: posts big blind 250
*** HOLE CARDS ***
Dealt to malik_msk [Tc Jd]
tetraodon86: folds 
Pete55558: folds 
Piton131313: folds 
Killererin: raises 250 to 500
malik_msk: calls 500
baztack: folds 
kruiiser: calls 500
baloobaloo00: calls 375
allanshrek01: calls 250
*** FLOP *** [8s Qh 8h]
baloobaloo00: checks 
allanshrek01: bets 250
Killererin: folds 
malik_msk: calls 250
kruiiser: folds 
baloobaloo00: folds 
*** TURN *** [8s Qh 8h] [5s]
allanshrek01: bets 250
malik_msk: calls 250
*** RIVER *** [8s Qh 8h 5s] [3c]
allanshrek01: bets 250
malik_msk: folds 
Uncalled bet (250) returned to allanshrek01
allanshrek01 collected 3770 from pot
allanshrek01: doesn't show hand 
*** SUMMARY ***
Total pot 3770 | Rake 0 
Board [8s Qh 8h 5s 3c]
Seat 1: Piton131313 folded before Flop (didn't bet)
Seat 2: Killererin folded on the Flop
Seat 3: malik_msk folded on the River
Seat 4: baztack folded before Flop (didn't bet)
Seat 5: kruiiser (button) folded on the Flop
Seat 6: baloobaloo00 (small blind) folded on the Flop
Seat 7: allanshrek01 (big blind) collected (3770)
Seat 8: tetraodon86 folded before Flop (didn't bet)
Seat 9: Pete55558 folded before Flop (didn't bet)



PokerStars Game #70066502534: Tournament #545010286, $5.00+$0.50 USD Hold'em No Limit - Level XI (125/250) - 2011/11/05 18:53:15 MSK [2011/11/05 10:53:15 ET]
Table '545010286 77' 9-max Seat #6 is the button
Seat 1: Piton131313 (10917 in chips) 
Seat 2: Killererin (33950 in chips) 
Seat 3: malik_msk (34295 in chips) 
Seat 4: baztack (10730 in chips) 
Seat 5: kruiiser (6194 in chips) 
Seat 6: baloobaloo00 (9306 in chips) 
Seat 7: allanshrek01 (6881 in chips) 
Seat 8: tetraodon86 (6787 in chips) 
Seat 9: Pete55558 (10513 in chips) 
Piton131313: posts the ante 30
Killererin: posts the ante 30
malik_msk: posts the ante 30
baztack: posts the ante 30
kruiiser: posts the ante 30
baloobaloo00: posts the ante 30
allanshrek01: posts the ante 30
tetraodon86: posts the ante 30
Pete55558: posts the ante 30
allanshrek01: posts small blind 125
tetraodon86: posts big blind 250
*** HOLE CARDS ***
Dealt to malik_msk [Qs 3c]
Pete55558: folds 
Piton131313: folds 
Killererin: raises 250 to 500
malik_msk: folds 
baztack: folds 
kruiiser: folds 
baloobaloo00: calls 500
allanshrek01 is connected 
allanshrek01: folds 
tetraodon86: folds 
*** FLOP *** [Ah Kh 9h]
Killererin: bets 1000
baloobaloo00: folds 
Uncalled bet (1000) returned to Killererin
Killererin collected 1645 from pot
Killererin: doesn't show hand 
*** SUMMARY ***
Total pot 1645 | Rake 0 
Board [Ah Kh 9h]
Seat 1: Piton131313 folded before Flop (didn't bet)
Seat 2: Killererin collected (1645)
Seat 3: malik_msk folded before Flop (didn't bet)
Seat 4: baztack folded before Flop (didn't bet)
Seat 5: kruiiser folded before Flop (didn't bet)
Seat 6: baloobaloo00 (button) folded on the Flop
Seat 7: allanshrek01 (small blind) folded before Flop
Seat 8: tetraodon86 (big blind) folded before Flop
Seat 9: Pete55558 folded before Flop (didn't bet)



PokerStars Game #70066563814: Tournament #545010286, $5.00+$0.50 USD Hold'em No Limit - Level XI (125/250) - 2011/11/05 18:54:39 MSK [2011/11/05 10:54:39 ET]
Table '545010286 77' 9-max Seat #7 is the button
Seat 1: Piton131313 (10887 in chips) 
Seat 2: Killererin (35065 in chips) 
Seat 3: malik_msk (34265 in chips) 
Seat 4: baztack (10700 in chips) 
Seat 5: kruiiser (6164 in chips) 
Seat 6: baloobaloo00 (8776 in chips) 
Seat 7: allanshrek01 (6726 in chips) 
Seat 8: tetraodon86 (6507 in chips) 
Seat 9: Pete55558 (10483 in chips) 
Piton131313: posts the ante 30
Killererin: posts the ante 30
malik_msk: posts the ante 30
baztack: posts the ante 30
kruiiser: posts the ante 30
baloobaloo00: posts the ante 30
allanshrek01: posts the ante 30
tetraodon86: posts the ante 30
Pete55558: posts the ante 30
tetraodon86: posts small blind 125
Pete55558: posts big blind 250
*** HOLE CARDS ***
Dealt to malik_msk [4c 2s]
Piton131313: raises 425 to 675
Killererin: folds 
malik_msk: folds 
baztack: folds 
kruiiser: folds 
baloobaloo00: folds 
allanshrek01: folds 
tetraodon86: folds 
Pete55558: calls 425
*** FLOP *** [Kd Jc Ad]
Pete55558: checks 
Piton131313: bets 1125
Pete55558: calls 1125
*** TURN *** [Kd Jc Ad] [7h]
Pete55558: checks 
Piton131313: bets 2750
Pete55558: calls 2750
*** RIVER *** [Kd Jc Ad 7h] [As]
Pete55558: bets 750
Piton131313: raises 5557 to 6307 and is all-in
Pete55558: calls 5153 and is all-in
Uncalled bet (404) returned to Piton131313
*** SHOW DOWN ***
Piton131313: shows [Jh Js] (a full house, Jacks full of Aces)
Pete55558: shows [5h Ac] (three of a kind, Aces)
Piton131313 collected 21301 from pot
Pete55558 finished the tournament in 1363rd place
*** SUMMARY ***
Total pot 21301 | Rake 0 
Board [Kd Jc Ad 7h As]
Seat 1: Piton131313 showed [Jh Js] and won (21301) with a full house, Jacks full of Aces
Seat 2: Killererin folded before Flop (didn't bet)
Seat 3: malik_msk folded before Flop (didn't bet)
Seat 4: baztack folded before Flop (didn't bet)
Seat 5: kruiiser folded before Flop (didn't bet)
Seat 6: baloobaloo00 folded before Flop (didn't bet)
Seat 7: allanshrek01 (button) folded before Flop (didn't bet)
Seat 8: tetraodon86 (small blind) folded before Flop
Seat 9: Pete55558 (big blind) showed [5h Ac] and lost with three of a kind, Aces



PokerStars Game #70066883856: Tournament #545010286, $5.00+$0.50 USD Hold'em No Limit - Level XI (125/250) - 2011/11/05 19:03:06 MSK [2011/11/05 11:03:06 ET]
Table '545010286 77' 9-max Seat #8 is the button
Seat 1: Piton131313 (21705 in chips) 
Seat 2: Killererin (35035 in chips) 
Seat 3: malik_msk (34235 in chips) 
Seat 4: baztack (10670 in chips) 
Seat 5: kruiiser (6134 in chips) 
Seat 6: baloobaloo00 (8746 in chips) 
Seat 7: allanshrek01 (6696 in chips) 
Seat 8: tetraodon86 (6352 in chips) 
Seat 9: insomniac_jc (2733 in chips) out of hand (moved from another table into small blind)
Piton131313: posts the ante 30
Killererin: posts the ante 30
malik_msk: posts the ante 30
baztack: posts the ante 30
kruiiser: posts the ante 30
baloobaloo00: posts the ante 30
allanshrek01: posts the ante 30
tetraodon86: posts the ante 30
Piton131313: posts small blind 125
Killererin: posts big blind 250
*** HOLE CARDS ***
Dealt to malik_msk [4c 3h]
malik_msk: folds 
baztack: raises 250 to 500
kruiiser: folds 
baloobaloo00: folds 
allanshrek01: folds 
tetraodon86: calls 500
Piton131313: folds 
Killererin: folds 
*** FLOP *** [4h Tc 7c]
baztack: bets 850
tetraodon86: calls 850
*** TURN *** [4h Tc 7c] [8h]
baztack: checks 
tetraodon86: bets 2000
baztack: folds 
Uncalled bet (2000) returned to tetraodon86
tetraodon86 collected 3315 from pot
tetraodon86: doesn't show hand 
*** SUMMARY ***
Total pot 3315 | Rake 0 
Board [4h Tc 7c 8h]
Seat 1: Piton131313 (small blind) folded before Flop
Seat 2: Killererin (big blind) folded before Flop
Seat 3: malik_msk folded before Flop (didn't bet)
Seat 4: baztack folded on the Turn
Seat 5: kruiiser folded before Flop (didn't bet)
Seat 6: baloobaloo00 folded before Flop (didn't bet)
Seat 7: allanshrek01 folded before Flop (didn't bet)
Seat 8: tetraodon86 (button) collected (3315)



PokerStars Game #70066922137: Tournament #545010286, $5.00+$0.50 USD Hold'em No Limit - Level XI (125/250) - 2011/11/05 19:03:56 MSK [2011/11/05 11:03:56 ET]
Table '545010286 77' 9-max Seat #1 is the button
Seat 1: Piton131313 (21550 in chips) 
Seat 2: Killererin (34755 in chips) 
Seat 3: malik_msk (34205 in chips) 
Seat 4: baztack (9290 in chips) 
Seat 5: kruiiser (6104 in chips) 
Seat 6: baloobaloo00 (8716 in chips) 
Seat 7: allanshrek01 (6666 in chips) 
Seat 8: tetraodon86 (8287 in chips) 
Seat 9: insomniac_jc (2733 in chips) 
Piton131313: posts the ante 30
Killererin: posts the ante 30
malik_msk: posts the ante 30
baztack: posts the ante 30
kruiiser: posts the ante 30
baloobaloo00: posts the ante 30
allanshrek01: posts the ante 30
tetraodon86: posts the ante 30
insomniac_jc: posts the ante 30
Killererin: posts small blind 125
malik_msk: posts big blind 250
*** HOLE CARDS ***
Dealt to malik_msk [Qh 6d]
baztack: folds 
kruiiser: raises 335 to 585
baloobaloo00: folds 
allanshrek01: folds 
tetraodon86: folds 
insomniac_jc: folds 
Piton131313: folds 
Killererin: folds 
malik_msk: folds 
Uncalled bet (335) returned to kruiiser
kruiiser collected 895 from pot
*** SUMMARY ***
Total pot 895 | Rake 0 
Seat 1: Piton131313 (button) folded before Flop (didn't bet)
Seat 2: Killererin (small blind) folded before Flop
Seat 3: malik_msk (big blind) folded before Flop
Seat 4: baztack folded before Flop (didn't bet)
Seat 5: kruiiser collected (895)
Seat 6: baloobaloo00 folded before Flop (didn't bet)
Seat 7: allanshrek01 folded before Flop (didn't bet)
Seat 8: tetraodon86 folded before Flop (didn't bet)
Seat 9: insomniac_jc folded before Flop (didn't bet)



PokerStars Game #70066947377: Tournament #545010286, $5.00+$0.50 USD Hold'em No Limit - Level XI (125/250) - 2011/11/05 19:04:29 MSK [2011/11/05 11:04:29 ET]
Table '545010286 77' 9-max Seat #2 is the button
Seat 1: Piton131313 (21520 in chips) 
Seat 2: Killererin (34600 in chips) 
Seat 3: malik_msk (33925 in chips) 
Seat 4: baztack (9260 in chips) 
Seat 5: kruiiser (6719 in chips) 
Seat 6: baloobaloo00 (8686 in chips) 
Seat 7: allanshrek01 (6636 in chips) 
Seat 8: tetraodon86 (8257 in chips) 
Seat 9: insomniac_jc (2703 in chips) 
Piton131313: posts the ante 30
Killererin: posts the ante 30
malik_msk: posts the ante 30
baztack: posts the ante 30
kruiiser: posts the ante 30
baloobaloo00: posts the ante 30
allanshrek01: posts the ante 30
tetraodon86: posts the ante 30
insomniac_jc: posts the ante 30
malik_msk: posts small blind 125
baztack: posts big blind 250
*** HOLE CARDS ***
Dealt to malik_msk [Td 9c]
kruiiser: folds 
baloobaloo00: folds 
allanshrek01: folds 
tetraodon86: folds 
insomniac_jc: folds 
Piton131313: folds 
Killererin: folds 
malik_msk: calls 125
baztack: checks 
*** FLOP *** [2c 4d 5h]
malik_msk: checks 
baztack: checks 
*** TURN *** [2c 4d 5h] [Jh]
malik_msk: bets 250
baztack: calls 250
*** RIVER *** [2c 4d 5h Jh] [8c]
malik_msk: checks 
baztack: checks 
*** SHOW DOWN ***
malik_msk: shows [Td 9c] (high card Jack)
baztack: shows [3d 8h] (a pair of Eights)
baztack collected 1270 from pot
*** SUMMARY ***
Total pot 1270 | Rake 0 
Board [2c 4d 5h Jh 8c]
Seat 1: Piton131313 folded before Flop (didn't bet)
Seat 2: Killererin (button) folded before Flop (didn't bet)
Seat 3: malik_msk (small blind) showed [Td 9c] and lost with high card Jack
Seat 4: baztack (big blind) showed [3d 8h] and won (1270) with a pair of Eights
Seat 5: kruiiser folded before Flop (didn't bet)
Seat 6: baloobaloo00 folded before Flop (didn't bet)
Seat 7: allanshrek01 folded before Flop (didn't bet)
Seat 8: tetraodon86 folded before Flop (didn't bet)
Seat 9: insomniac_jc folded before Flop (didn't bet)



PokerStars Game #70066986136: Tournament #545010286, $5.00+$0.50 USD Hold'em No Limit - Level XI (125/250) - 2011/11/05 19:05:18 MSK [2011/11/05 11:05:18 ET]
Table '545010286 77' 9-max Seat #3 is the button
Seat 1: Piton131313 (21490 in chips) 
Seat 2: Killererin (34570 in chips) 
Seat 3: malik_msk (33395 in chips) 
Seat 4: baztack (10000 in chips) 
Seat 5: kruiiser (6689 in chips) 
Seat 6: baloobaloo00 (8656 in chips) 
Seat 7: allanshrek01 (6606 in chips) 
Seat 8: tetraodon86 (8227 in chips) 
Seat 9: insomniac_jc (2673 in chips) 
Piton131313: posts the ante 30
Killererin: posts the ante 30
malik_msk: posts the ante 30
baztack: posts the ante 30
kruiiser: posts the ante 30
baloobaloo00: posts the ante 30
allanshrek01: posts the ante 30
tetraodon86: posts the ante 30
insomniac_jc: posts the ante 30
baztack: posts small blind 125
kruiiser: posts big blind 250
*** HOLE CARDS ***
Dealt to malik_msk [Kc Ks]
baloobaloo00: folds 
allanshrek01: folds 
tetraodon86: folds 
insomniac_jc: folds 
Piton131313: raises 425 to 675
Killererin: folds 
malik_msk: raises 425 to 1100
baztack: folds 
kruiiser: folds 
Piton131313: calls 425
*** FLOP *** [5h Ah Jd]
Piton131313: checks 
malik_msk: checks 
*** TURN *** [5h Ah Jd] [Ac]
Piton131313: checks 
malik_msk: checks 
*** RIVER *** [5h Ah Jd Ac] [Qs]
Piton131313: checks 
malik_msk: checks 
*** SHOW DOWN ***
Piton131313: shows [4s 5s] (two pair, Aces and Fives)
malik_msk: shows [Kc Ks] (two pair, Aces and Kings)
malik_msk collected 2845 from pot
*** SUMMARY ***
Total pot 2845 | Rake 0 
Board [5h Ah Jd Ac Qs]
Seat 1: Piton131313 showed [4s 5s] and lost with two pair, Aces and Fives
Seat 2: Killererin folded before Flop (didn't bet)
Seat 3: malik_msk (button) showed [Kc Ks] and won (2845) with two pair, Aces and Kings
Seat 4: baztack (small blind) folded before Flop
Seat 5: kruiiser (big blind) folded before Flop
Seat 6: baloobaloo00 folded before Flop (didn't bet)
Seat 7: allanshrek01 folded before Flop (didn't bet)
Seat 8: tetraodon86 folded before Flop (didn't bet)
Seat 9: insomniac_jc folded before Flop (didn't bet)



PokerStars Game #70067031121: Tournament #545010286, $5.00+$0.50 USD Hold'em No Limit - Level XII (150/300) - 2011/11/05 19:06:15 MSK [2011/11/05 11:06:15 ET]
Table '545010286 77' 9-max Seat #4 is the button
Seat 1: Piton131313 (20360 in chips) 
Seat 2: Killererin (34540 in chips) 
Seat 3: malik_msk (35110 in chips) 
Seat 4: baztack (9845 in chips) 
Seat 5: kruiiser (6409 in chips) 
Seat 6: baloobaloo00 (8626 in chips) 
Seat 7: allanshrek01 (6576 in chips) 
Seat 8: tetraodon86 (8197 in chips) 
Seat 9: insomniac_jc (2643 in chips) 
Piton131313: posts the ante 40
Killererin: posts the ante 40
malik_msk: posts the ante 40
baztack: posts the ante 40
kruiiser: posts the ante 40
baloobaloo00: posts the ante 40
allanshrek01: posts the ante 40
tetraodon86: posts the ante 40
insomniac_jc: posts the ante 40
kruiiser: posts small blind 150
baloobaloo00: posts big blind 300
*** HOLE CARDS ***
Dealt to malik_msk [6h 4c]
kruiiser is connected 
allanshrek01: calls 300
tetraodon86: folds 
insomniac_jc: folds 
Piton131313: folds 
Killererin: raises 600 to 900
malik_msk: folds 
baztack: folds 
kruiiser: raises 900 to 1800
baloobaloo00: folds 
allanshrek01: folds 
Killererin: folds 
Uncalled bet (900) returned to kruiiser
kruiiser collected 2760 from pot
kruiiser: doesn't show hand 
*** SUMMARY ***
Total pot 2760 | Rake 0 
Seat 1: Piton131313 folded before Flop (didn't bet)
Seat 2: Killererin folded before Flop
Seat 3: malik_msk folded before Flop (didn't bet)
Seat 4: baztack (button) folded before Flop (didn't bet)
Seat 5: kruiiser (small blind) collected (2760)
Seat 6: baloobaloo00 (big blind) folded before Flop
Seat 7: allanshrek01 folded before Flop
Seat 8: tetraodon86 folded before Flop (didn't bet)
Seat 9: insomniac_jc folded before Flop (didn't bet)



PokerStars Game #70067067049: Tournament #545010286, $5.00+$0.50 USD Hold'em No Limit - Level XII (150/300) - 2011/11/05 19:07:01 MSK [2011/11/05 11:07:01 ET]
Table '545010286 77' 9-max Seat #5 is the button
Seat 1: Piton131313 (20320 in chips) 
Seat 2: Killererin (33600 in chips) 
Seat 3: malik_msk (35070 in chips) 
Seat 4: baztack (9805 in chips) 
Seat 5: kruiiser (8229 in chips) 
Seat 6: baloobaloo00 (8286 in chips) 
Seat 7: allanshrek01 (6236 in chips) 
Seat 8: tetraodon86 (8157 in chips) 
Seat 9: insomniac_jc (2603 in chips) 
Piton131313: posts the ante 40
Killererin: posts the ante 40
malik_msk: posts the ante 40
baztack: posts the ante 40
kruiiser: posts the ante 40
baloobaloo00: posts the ante 40
allanshrek01: posts the ante 40
tetraodon86: posts the ante 40
insomniac_jc: posts the ante 40
baloobaloo00: posts small blind 150
allanshrek01: posts big blind 300
*** HOLE CARDS ***
Dealt to malik_msk [8c 9d]
tetraodon86: folds 
insomniac_jc: calls 300
Piton131313: folds 
Killererin: raises 600 to 900
malik_msk: folds 
baztack: folds 
kruiiser: folds 
baloobaloo00: folds 
allanshrek01: folds 
insomniac_jc: calls 600
*** FLOP *** [2c 2d 4d]
insomniac_jc: bets 1663 and is all-in
Killererin: calls 1663
*** TURN *** [2c 2d 4d] [7h]
*** RIVER *** [2c 2d 4d 7h] [Jh]
*** SHOW DOWN ***
insomniac_jc: shows [6c 6d] (two pair, Sixes and Deuces)
Killererin: shows [As Qh] (a pair of Deuces)
insomniac_jc collected 5936 from pot
*** SUMMARY ***
Total pot 5936 | Rake 0 
Board [2c 2d 4d 7h Jh]
Seat 1: Piton131313 folded before Flop (didn't bet)
Seat 2: Killererin showed [As Qh] and lost with a pair of Deuces
Seat 3: malik_msk folded before Flop (didn't bet)
Seat 4: baztack folded before Flop (didn't bet)
Seat 5: kruiiser (button) folded before Flop (didn't bet)
Seat 6: baloobaloo00 (small blind) folded before Flop
Seat 7: allanshrek01 (big blind) folded before Flop
Seat 8: tetraodon86 folded before Flop (didn't bet)
Seat 9: insomniac_jc showed [6c 6d] and won (5936) with two pair, Sixes and Deuces



PokerStars Game #70067104967: Tournament #545010286, $5.00+$0.50 USD Hold'em No Limit - Level XII (150/300) - 2011/11/05 19:07:49 MSK [2011/11/05 11:07:49 ET]
Table '545010286 77' 9-max Seat #6 is the button
Seat 1: Piton131313 (20280 in chips) 
Seat 2: Killererin (30997 in chips) 
Seat 3: malik_msk (35030 in chips) 
Seat 4: baztack (9765 in chips) 
Seat 5: kruiiser (8189 in chips) 
Seat 6: baloobaloo00 (8096 in chips) 
Seat 7: allanshrek01 (5896 in chips) 
Seat 8: tetraodon86 (8117 in chips) 
Seat 9: insomniac_jc (5936 in chips) 
Piton131313: posts the ante 40
Killererin: posts the ante 40
malik_msk: posts the ante 40
baztack: posts the ante 40
kruiiser: posts the ante 40
baloobaloo00: posts the ante 40
allanshrek01: posts the ante 40
tetraodon86: posts the ante 40
insomniac_jc: posts the ante 40
allanshrek01: posts small blind 150
tetraodon86: posts big blind 300
*** HOLE CARDS ***
Dealt to malik_msk [6d Kh]
insomniac_jc: folds 
Piton131313: raises 510 to 810
Killererin: calls 810
malik_msk: folds 
baztack: folds 
kruiiser: calls 810
baloobaloo00: folds 
allanshrek01: calls 660
tetraodon86: calls 510
*** FLOP *** [Ac 9d 6h]
allanshrek01: bets 900
tetraodon86: folds 
Piton131313: calls 900
Killererin: folds 
kruiiser: raises 1200 to 2100
allanshrek01: calls 1200
Piton131313: folds 
*** TURN *** [Ac 9d 6h] [5h]
allanshrek01: checks 
kruiiser: bets 5239 and is all-in
allanshrek01: folds 
Uncalled bet (5239) returned to kruiiser
kruiiser collected 9510 from pot
*** SUMMARY ***
Total pot 9510 | Rake 0 
Board [Ac 9d 6h 5h]
Seat 1: Piton131313 folded on the Flop
Seat 2: Killererin folded on the Flop
Seat 3: malik_msk folded before Flop (didn't bet)
Seat 4: baztack folded before Flop (didn't bet)
Seat 5: kruiiser collected (9510)
Seat 6: baloobaloo00 (button) folded before Flop (didn't bet)
Seat 7: allanshrek01 (small blind) folded on the Turn
Seat 8: tetraodon86 (big blind) folded on the Flop
Seat 9: insomniac_jc folded before Flop (didn't bet)



PokerStars Game #70067165875: Tournament #545010286, $5.00+$0.50 USD Hold'em No Limit - Level XII (150/300) - 2011/11/05 19:09:07 MSK [2011/11/05 11:09:07 ET]
Table '545010286 77' 9-max Seat #7 is the button
Seat 1: Piton131313 (18530 in chips) 
Seat 2: Killererin (30147 in chips) 
Seat 3: malik_msk (34990 in chips) 
Seat 4: baztack (9725 in chips) 
Seat 5: kruiiser (14749 in chips) 
Seat 6: baloobaloo00 (8056 in chips) 
Seat 7: allanshrek01 (2946 in chips) 
Seat 8: tetraodon86 (7267 in chips) 
Seat 9: insomniac_jc (5896 in chips) 
Piton131313: posts the ante 40
Killererin: posts the ante 40
malik_msk: posts the ante 40
baztack: posts the ante 40
kruiiser: posts the ante 40
baloobaloo00: posts the ante 40
allanshrek01: posts the ante 40
tetraodon86: posts the ante 40
insomniac_jc: posts the ante 40
tetraodon86: posts small blind 150
insomniac_jc: posts big blind 300
*** HOLE CARDS ***
Dealt to malik_msk [Kc 4s]
Piton131313: raises 510 to 810
Killererin: folds 
malik_msk: folds 
baztack: folds 
kruiiser: folds 
baloobaloo00: folds 
allanshrek01: folds 
tetraodon86: folds 
insomniac_jc: folds 
Uncalled bet (510) returned to Piton131313
Piton131313 collected 1110 from pot
*** SUMMARY ***
Total pot 1110 | Rake 0 
Seat 1: Piton131313 collected (1110)
Seat 2: Killererin folded before Flop (didn't bet)
Seat 3: malik_msk folded before Flop (didn't bet)
Seat 4: baztack folded before Flop (didn't bet)
Seat 5: kruiiser folded before Flop (didn't bet)
Seat 6: baloobaloo00 folded before Flop (didn't bet)
Seat 7: allanshrek01 (button) folded before Flop (didn't bet)
Seat 8: tetraodon86 (small blind) folded before Flop
Seat 9: insomniac_jc (big blind) folded before Flop



PokerStars Game #70067189975: Tournament #545010286, $5.00+$0.50 USD Hold'em No Limit - Level XII (150/300) - 2011/11/05 19:09:38 MSK [2011/11/05 11:09:38 ET]
Table '545010286 77' 9-max Seat #8 is the button
Seat 1: Piton131313 (19300 in chips) 
Seat 2: Killererin (30107 in chips) 
Seat 3: malik_msk (34950 in chips) 
Seat 4: baztack (9685 in chips) 
Seat 5: kruiiser (14709 in chips) 
Seat 6: baloobaloo00 (8016 in chips) 
Seat 7: allanshrek01 (2906 in chips) 
Seat 8: tetraodon86 (7077 in chips) 
Seat 9: insomniac_jc (5556 in chips) 
Piton131313: posts the ante 40
Killererin: posts the ante 40
malik_msk: posts the ante 40
baztack: posts the ante 40
kruiiser: posts the ante 40
baloobaloo00: posts the ante 40
allanshrek01: posts the ante 40
tetraodon86: posts the ante 40
insomniac_jc: posts the ante 40
insomniac_jc: posts small blind 150
Piton131313: posts big blind 300
*** HOLE CARDS ***
Dealt to malik_msk [Jc 8c]
Killererin: folds 
malik_msk: raises 300 to 600
baztack: folds 
kruiiser: folds 
baloobaloo00: folds 
allanshrek01: folds 
tetraodon86: folds 
insomniac_jc: folds 
Piton131313: folds 
Uncalled bet (300) returned to malik_msk
malik_msk collected 1110 from pot
malik_msk: doesn't show hand 
*** SUMMARY ***
Total pot 1110 | Rake 0 
Seat 1: Piton131313 (big blind) folded before Flop
Seat 2: Killererin folded before Flop (didn't bet)
Seat 3: malik_msk collected (1110)
Seat 4: baztack folded before Flop (didn't bet)
Seat 5: kruiiser folded before Flop (didn't bet)
Seat 6: baloobaloo00 folded before Flop (didn't bet)
Seat 7: allanshrek01 folded before Flop (didn't bet)
Seat 8: tetraodon86 (button) folded before Flop (didn't bet)
Seat 9: insomniac_jc (small blind) folded before Flop



PokerStars Game #70067216241: Tournament #545010286, $5.00+$0.50 USD Hold'em No Limit - Level XII (150/300) - 2011/11/05 19:10:11 MSK [2011/11/05 11:10:11 ET]
Table '545010286 77' 9-max Seat #9 is the button
Seat 1: Piton131313 (18960 in chips) 
Seat 2: Killererin (30067 in chips) 
Seat 3: malik_msk (35720 in chips) 
Seat 4: baztack (9645 in chips) 
Seat 5: kruiiser (14669 in chips) 
Seat 6: baloobaloo00 (7976 in chips) 
Seat 7: allanshrek01 (2866 in chips) 
Seat 8: tetraodon86 (7037 in chips) 
Seat 9: insomniac_jc (5366 in chips) 
Piton131313: posts the ante 40
Killererin: posts the ante 40
malik_msk: posts the ante 40
baztack: posts the ante 40
kruiiser: posts the ante 40
baloobaloo00: posts the ante 40
allanshrek01: posts the ante 40
tetraodon86: posts the ante 40
insomniac_jc: posts the ante 40
Piton131313: posts small blind 150
Killererin: posts big blind 300
*** HOLE CARDS ***
Dealt to malik_msk [Qh 2h]
malik_msk: folds 
baztack: folds 
kruiiser: folds 
baloobaloo00: folds 
allanshrek01: raises 2526 to 2826 and is all-in
tetraodon86: folds 
insomniac_jc: folds 
Piton131313: folds 
Killererin: calls 2526
*** FLOP *** [Th 8c 4d]
*** TURN *** [Th 8c 4d] [8h]
*** RIVER *** [Th 8c 4d 8h] [5s]
*** SHOW DOWN ***
Killererin: shows [As Ah] (two pair, Aces and Eights)
allanshrek01: shows [6h 6d] (two pair, Eights and Sixes)
Killererin collected 6162 from pot
allanshrek01 finished the tournament in 1208th place
*** SUMMARY ***
Total pot 6162 | Rake 0 
Board [Th 8c 4d 8h 5s]
Seat 1: Piton131313 (small blind) folded before Flop
Seat 2: Killererin (big blind) showed [As Ah] and won (6162) with two pair, Aces and Eights
Seat 3: malik_msk folded before Flop (didn't bet)
Seat 4: baztack folded before Flop (didn't bet)
Seat 5: kruiiser folded before Flop (didn't bet)
Seat 6: baloobaloo00 folded before Flop (didn't bet)
Seat 7: allanshrek01 showed [6h 6d] and lost with two pair, Eights and Sixes
Seat 8: tetraodon86 folded before Flop (didn't bet)
Seat 9: insomniac_jc (button) folded before Flop (didn't bet)



PokerStars Game #70067255368: Tournament #545010286, $5.00+$0.50 USD Hold'em No Limit - Level XII (150/300) - 2011/11/05 19:11:01 MSK [2011/11/05 11:11:01 ET]
Table '545010286 77' 9-max Seat #1 is the button
Seat 1: Piton131313 (18770 in chips) 
Seat 2: Killererin (33363 in chips) 
Seat 3: malik_msk (35680 in chips) 
Seat 4: baztack (9605 in chips) 
Seat 5: kruiiser (14629 in chips) 
Seat 6: baloobaloo00 (7936 in chips) 
Seat 7: miquelCdP (16670 in chips) 
Seat 8: tetraodon86 (6997 in chips) 
Seat 9: insomniac_jc (5326 in chips) 
Piton131313: posts the ante 40
Killererin: posts the ante 40
malik_msk: posts the ante 40
baztack: posts the ante 40
kruiiser: posts the ante 40
baloobaloo00: posts the ante 40
miquelCdP: posts the ante 40
tetraodon86: posts the ante 40
insomniac_jc: posts the ante 40
Killererin: posts small blind 150
malik_msk: posts big blind 300
*** HOLE CARDS ***
Dealt to malik_msk [8s Ac]
baztack: folds 
kruiiser: folds 
baloobaloo00: raises 600 to 900
miquelCdP: folds 
tetraodon86: folds 
insomniac_jc: folds 
Piton131313: folds 
Killererin: folds 
malik_msk: calls 600
*** FLOP *** [Js 4c Qh]
malik_msk: checks 
baloobaloo00: bets 900
malik_msk: folds 
Uncalled bet (900) returned to baloobaloo00
baloobaloo00 collected 2310 from pot
baloobaloo00: doesn't show hand 
*** SUMMARY ***
Total pot 2310 | Rake 0 
Board [Js 4c Qh]
Seat 1: Piton131313 (button) folded before Flop (didn't bet)
Seat 2: Killererin (small blind) folded before Flop
Seat 3: malik_msk (big blind) folded on the Flop
Seat 4: baztack folded before Flop (didn't bet)
Seat 5: kruiiser folded before Flop (didn't bet)
Seat 6: baloobaloo00 collected (2310)
Seat 7: miquelCdP folded before Flop (didn't bet)
Seat 8: tetraodon86 folded before Flop (didn't bet)
Seat 9: insomniac_jc folded before Flop (didn't bet)



PokerStars Game #70067287697: Tournament #545010286, $5.00+$0.50 USD Hold'em No Limit - Level XII (150/300) - 2011/11/05 19:11:43 MSK [2011/11/05 11:11:43 ET]
Table '545010286 77' 9-max Seat #2 is the button
Seat 1: Piton131313 (18730 in chips) 
Seat 2: Killererin (33173 in chips) 
Seat 3: malik_msk (34740 in chips) 
Seat 4: baztack (9565 in chips) 
Seat 5: kruiiser (14589 in chips) 
Seat 6: baloobaloo00 (9306 in chips) 
Seat 7: miquelCdP (16630 in chips) 
Seat 8: tetraodon86 (6957 in chips) 
Seat 9: insomniac_jc (5286 in chips) 
Piton131313: posts the ante 40
Killererin: posts the ante 40
malik_msk: posts the ante 40
baztack: posts the ante 40
kruiiser: posts the ante 40
baloobaloo00: posts the ante 40
miquelCdP: posts the ante 40
tetraodon86: posts the ante 40
insomniac_jc: posts the ante 40
malik_msk: posts small blind 150
baztack: posts big blind 300
*** HOLE CARDS ***
Dealt to malik_msk [5c 3d]
kruiiser: folds 
baloobaloo00: folds 
miquelCdP: folds 
tetraodon86: raises 375 to 675
insomniac_jc: folds 
Piton131313: calls 675
Killererin: folds 
malik_msk: calls 525
baztack: folds 
*** FLOP *** [4h 9h Ah]
malik_msk: checks 
tetraodon86: checks 
Piton131313: checks 
*** TURN *** [4h 9h Ah] [Kd]
malik_msk: bets 900
tetraodon86: folds 
Piton131313: calls 900
*** RIVER *** [4h 9h Ah Kd] [8c]
malik_msk: bets 2400
Piton131313: folds 
Uncalled bet (2400) returned to malik_msk
malik_msk collected 4485 from pot
malik_msk: doesn't show hand 
*** SUMMARY ***
Total pot 4485 | Rake 0 
Board [4h 9h Ah Kd 8c]
Seat 1: Piton131313 folded on the River
Seat 2: Killererin (button) folded before Flop (didn't bet)
Seat 3: malik_msk (small blind) collected (4485)
Seat 4: baztack (big blind) folded before Flop
Seat 5: kruiiser folded before Flop (didn't bet)
Seat 6: baloobaloo00 folded before Flop (didn't bet)
Seat 7: miquelCdP folded before Flop (didn't bet)
Seat 8: tetraodon86 folded on the Turn
Seat 9: insomniac_jc folded before Flop (didn't bet)



PokerStars Game #70067368751: Tournament #545010286, $5.00+$0.50 USD Hold'em No Limit - Level XII (150/300) - 2011/11/05 19:13:27 MSK [2011/11/05 11:13:27 ET]
Table '545010286 77' 9-max Seat #3 is the button
Seat 1: Piton131313 (17115 in chips) 
Seat 2: Killererin (33133 in chips) 
Seat 3: malik_msk (37610 in chips) 
Seat 4: baztack (9225 in chips) 
Seat 5: kruiiser (14549 in chips) 
Seat 6: baloobaloo00 (9266 in chips) 
Seat 7: miquelCdP (16590 in chips) 
Seat 8: tetraodon86 (6242 in chips) 
Seat 9: insomniac_jc (5246 in chips) 
Piton131313: posts the ante 40
Killererin: posts the ante 40
malik_msk: posts the ante 40
baztack: posts the ante 40
kruiiser: posts the ante 40
baloobaloo00: posts the ante 40
miquelCdP: posts the ante 40
tetraodon86: posts the ante 40
insomniac_jc: posts the ante 40
baztack: posts small blind 150
kruiiser: posts big blind 300
*** HOLE CARDS ***
Dealt to malik_msk [5s 8h]
baloobaloo00: folds 
miquelCdP: raises 600 to 900
tetraodon86: folds 
insomniac_jc: folds 
Piton131313: folds 
Killererin: calls 900
malik_msk: folds 
baztack: folds 
kruiiser: folds 
*** FLOP *** [4d 3s 4h]
miquelCdP: bets 1800
Killererin: calls 1800
*** TURN *** [4d 3s 4h] [Kh]
miquelCdP: bets 4200
Killererin: folds 
Uncalled bet (4200) returned to miquelCdP
miquelCdP collected 6210 from pot
*** SUMMARY ***
Total pot 6210 | Rake 0 
Board [4d 3s 4h Kh]
Seat 1: Piton131313 folded before Flop (didn't bet)
Seat 2: Killererin folded on the Turn
Seat 3: malik_msk (button) folded before Flop (didn't bet)
Seat 4: baztack (small blind) folded before Flop
Seat 5: kruiiser (big blind) folded before Flop
Seat 6: baloobaloo00 folded before Flop (didn't bet)
Seat 7: miquelCdP collected (6210)
Seat 8: tetraodon86 folded before Flop (didn't bet)
Seat 9: insomniac_jc folded before Flop (didn't bet)



PokerStars Game #70067404696: Tournament #545010286, $5.00+$0.50 USD Hold'em No Limit - Level XII (150/300) - 2011/11/05 19:14:13 MSK [2011/11/05 11:14:13 ET]
Table '545010286 77' 9-max Seat #4 is the button
Seat 1: Piton131313 (17075 in chips) 
Seat 2: Killererin (30393 in chips) 
Seat 3: malik_msk (37570 in chips) 
Seat 4: baztack (9035 in chips) 
Seat 5: kruiiser (14209 in chips) 
Seat 6: baloobaloo00 (9226 in chips) 
Seat 7: miquelCdP (20060 in chips) 
Seat 8: tetraodon86 (6202 in chips) 
Seat 9: insomniac_jc (5206 in chips) 
Piton131313: posts the ante 40
Killererin: posts the ante 40
malik_msk: posts the ante 40
baztack: posts the ante 40
kruiiser: posts the ante 40
baloobaloo00: posts the ante 40
miquelCdP: posts the ante 40
tetraodon86: posts the ante 40
insomniac_jc: posts the ante 40
kruiiser: posts small blind 150
baloobaloo00: posts big blind 300
*** HOLE CARDS ***
Dealt to malik_msk [7c 9h]
miquelCdP: calls 300
tetraodon86: raises 600 to 900
insomniac_jc: folds 
Piton131313: folds 
Killererin: folds 
malik_msk: folds 
baztack: folds 
kruiiser: folds 
baloobaloo00: folds 
miquelCdP: calls 600
*** FLOP *** [Jc 6s Td]
miquelCdP: bets 19120 and is all-in
tetraodon86: calls 5262 and is all-in
Uncalled bet (13858) returned to miquelCdP
*** TURN *** [Jc 6s Td] [Js]
*** RIVER *** [Jc 6s Td Js] [Ad]
*** SHOW DOWN ***
miquelCdP: shows [Jh Ac] (a full house, Jacks full of Aces)
tetraodon86: shows [Qh Ah] (two pair, Aces and Jacks)
miquelCdP collected 13134 from pot
tetraodon86 finished the tournament in 1139th place
*** SUMMARY ***
Total pot 13134 | Rake 0 
Board [Jc 6s Td Js Ad]
Seat 1: Piton131313 folded before Flop (didn't bet)
Seat 2: Killererin folded before Flop (didn't bet)
Seat 3: malik_msk folded before Flop (didn't bet)
Seat 4: baztack (button) folded before Flop (didn't bet)
Seat 5: kruiiser (small blind) folded before Flop
Seat 6: baloobaloo00 (big blind) folded before Flop
Seat 7: miquelCdP showed [Jh Ac] and won (13134) with a full house, Jacks full of Aces
Seat 8: tetraodon86 showed [Qh Ah] and lost with two pair, Aces and Jacks
Seat 9: insomniac_jc folded before Flop (didn't bet)



PokerStars Game #70067438625: Tournament #545010286, $5.00+$0.50 USD Hold'em No Limit - Level XII (150/300) - 2011/11/05 19:14:56 MSK [2011/11/05 11:14:56 ET]
Table '545010286 77' 9-max Seat #5 is the button
Seat 1: Piton131313 (17035 in chips) 
Seat 2: Killererin (30353 in chips) 
Seat 3: malik_msk (37530 in chips) 
Seat 4: baztack (8995 in chips) 
Seat 5: kruiiser (14019 in chips) 
Seat 6: baloobaloo00 (8886 in chips) 
Seat 7: miquelCdP (26992 in chips) 
Seat 9: insomniac_jc (5166 in chips) 
Piton131313: posts the ante 40
Killererin: posts the ante 40
malik_msk: posts the ante 40
baztack: posts the ante 40
kruiiser: posts the ante 40
baloobaloo00: posts the ante 40
miquelCdP: posts the ante 40
insomniac_jc: posts the ante 40
baloobaloo00: posts small blind 150
miquelCdP: posts big blind 300
*** HOLE CARDS ***
Dealt to malik_msk [3c 8h]
insomniac_jc: folds 
Piton131313: folds 
Killererin: folds 
malik_msk: folds 
baztack: folds 
kruiiser: folds 
baloobaloo00: calls 150
miquelCdP: checks 
*** FLOP *** [7d Kc 5s]
toitoitoi111 is connected 
baloobaloo00: checks 
miquelCdP: checks 
*** TURN *** [7d Kc 5s] [9s]
baloobaloo00: bets 300
miquelCdP: raises 600 to 900
baloobaloo00: calls 600
*** RIVER *** [7d Kc 5s 9s] [8c]
baloobaloo00: bets 300
miquelCdP: raises 900 to 1200
baloobaloo00: folds 
Uncalled bet (900) returned to miquelCdP
miquelCdP collected 3320 from pot
miquelCdP: shows [Kd Ad] (a pair of Kings)
*** SUMMARY ***
Total pot 3320 | Rake 0 
Board [7d Kc 5s 9s 8c]
Seat 1: Piton131313 folded before Flop (didn't bet)
Seat 2: Killererin folded before Flop (didn't bet)
Seat 3: malik_msk folded before Flop (didn't bet)
Seat 4: baztack folded before Flop (didn't bet)
Seat 5: kruiiser (button) folded before Flop (didn't bet)
Seat 6: baloobaloo00 (small blind) folded on the River
Seat 7: miquelCdP (big blind) collected (3320)
Seat 9: insomniac_jc folded before Flop (didn't bet)



PokerStars Game #70067478538: Tournament #545010286, $5.00+$0.50 USD Hold'em No Limit - Level XIII (200/400) - 2011/11/05 19:15:47 MSK [2011/11/05 11:15:47 ET]
Table '545010286 77' 9-max Seat #6 is the button
Seat 1: Piton131313 (16995 in chips) 
Seat 2: Killererin (30313 in chips) 
Seat 3: malik_msk (37490 in chips) 
Seat 4: baztack (8955 in chips) 
Seat 5: kruiiser (13979 in chips) 
Seat 6: baloobaloo00 (7346 in chips) 
Seat 7: miquelCdP (28772 in chips) 
Seat 8: toitoitoi111 (7905 in chips) 
Seat 9: insomniac_jc (5126 in chips) 
Piton131313: posts the ante 50
Killererin: posts the ante 50
malik_msk: posts the ante 50
baztack: posts the ante 50
kruiiser: posts the ante 50
baloobaloo00: posts the ante 50
miquelCdP: posts the ante 50
toitoitoi111: posts the ante 50
insomniac_jc: posts the ante 50
miquelCdP: posts small blind 200
toitoitoi111: posts big blind 400
*** HOLE CARDS ***
Dealt to malik_msk [2s Ah]
insomniac_jc: folds 
Piton131313: folds 
Killererin: folds 
malik_msk: calls 400
baztack: folds 
kruiiser: folds 
baloobaloo00 said, "nh"
baloobaloo00: calls 400
miquelCdP: folds 
toitoitoi111: checks 
*** FLOP *** [9s Kh Th]
miquelCdP said, "nice fold"
toitoitoi111: checks 
malik_msk: checks 
baloobaloo00: checks 
*** TURN *** [9s Kh Th] [Kc]
toitoitoi111: checks 
malik_msk: checks 
baloobaloo00: checks 
*** RIVER *** [9s Kh Th Kc] [3h]
toitoitoi111: bets 1600
malik_msk: folds 
baloobaloo00: folds 
Uncalled bet (1600) returned to toitoitoi111
toitoitoi111 collected 1850 from pot
toitoitoi111: doesn't show hand 
*** SUMMARY ***
Total pot 1850 | Rake 0 
Board [9s Kh Th Kc 3h]
Seat 1: Piton131313 folded before Flop (didn't bet)
Seat 2: Killererin folded before Flop (didn't bet)
Seat 3: malik_msk folded on the River
Seat 4: baztack folded before Flop (didn't bet)
Seat 5: kruiiser folded before Flop (didn't bet)
Seat 6: baloobaloo00 (button) folded on the River
Seat 7: miquelCdP (small blind) folded before Flop
Seat 8: toitoitoi111 (big blind) collected (1850)
Seat 9: insomniac_jc folded before Flop (didn't bet)



PokerStars Game #70067539726: Tournament #545010286, $5.00+$0.50 USD Hold'em No Limit - Level XIII (200/400) - 2011/11/05 19:17:05 MSK [2011/11/05 11:17:05 ET]
Table '545010286 77' 9-max Seat #7 is the button
Seat 1: Piton131313 (16945 in chips) 
Seat 2: Killererin (30263 in chips) 
Seat 3: malik_msk (37040 in chips) 
Seat 4: baztack (8905 in chips) 
Seat 5: kruiiser (13929 in chips) 
Seat 6: baloobaloo00 (6896 in chips) 
Seat 7: miquelCdP (28522 in chips) 
Seat 8: toitoitoi111 (9305 in chips) 
Seat 9: insomniac_jc (5076 in chips) 
Piton131313: posts the ante 50
Killererin: posts the ante 50
malik_msk: posts the ante 50
baztack: posts the ante 50
kruiiser: posts the ante 50
baloobaloo00: posts the ante 50
miquelCdP: posts the ante 50
toitoitoi111: posts the ante 50
insomniac_jc: posts the ante 50
toitoitoi111: posts small blind 200
insomniac_jc: posts big blind 400
*** HOLE CARDS ***
Dealt to malik_msk [Kd 8s]
Piton131313: folds 
Killererin: folds 
malik_msk: folds 
baztack: raises 400 to 800
kruiiser: folds 
baloobaloo00: folds 
miquelCdP: calls 800
toitoitoi111: folds 
insomniac_jc: calls 400
*** FLOP *** [6d 9s Qs]
insomniac_jc: checks 
baztack: bets 1200
miquelCdP: folds 
insomniac_jc: folds 
Uncalled bet (1200) returned to baztack
baztack collected 3050 from pot
baztack: doesn't show hand 
*** SUMMARY ***
Total pot 3050 | Rake 0 
Board [6d 9s Qs]
Seat 1: Piton131313 folded before Flop (didn't bet)
Seat 2: Killererin folded before Flop (didn't bet)
Seat 3: malik_msk folded before Flop (didn't bet)
Seat 4: baztack collected (3050)
Seat 5: kruiiser folded before Flop (didn't bet)
Seat 6: baloobaloo00 folded before Flop (didn't bet)
Seat 7: miquelCdP (button) folded on the Flop
Seat 8: toitoitoi111 (small blind) folded before Flop
Seat 9: insomniac_jc (big blind) folded on the Flop



PokerStars Game #70067571993: Tournament #545010286, $5.00+$0.50 USD Hold'em No Limit - Level XIII (200/400) - 2011/11/05 19:17:46 MSK [2011/11/05 11:17:46 ET]
Table '545010286 77' 9-max Seat #8 is the button
Seat 1: Piton131313 (16895 in chips) 
Seat 2: Killererin (30213 in chips) 
Seat 3: malik_msk (36990 in chips) 
Seat 4: baztack (11105 in chips) 
Seat 5: kruiiser (13879 in chips) 
Seat 6: baloobaloo00 (6846 in chips) 
Seat 7: miquelCdP (27672 in chips) 
Seat 8: toitoitoi111 (9055 in chips) 
Seat 9: insomniac_jc (4226 in chips) 
Piton131313: posts the ante 50
Killererin: posts the ante 50
malik_msk: posts the ante 50
baztack: posts the ante 50
kruiiser: posts the ante 50
baloobaloo00: posts the ante 50
miquelCdP: posts the ante 50
toitoitoi111: posts the ante 50
insomniac_jc: posts the ante 50
insomniac_jc: posts small blind 200
Piton131313: posts big blind 400
*** HOLE CARDS ***
Dealt to malik_msk [9h Tc]
Killererin: folds 
malik_msk: calls 400
baztack: folds 
kruiiser: folds 
baloobaloo00: folds 
miquelCdP: folds 
toitoitoi111: calls 400
insomniac_jc: calls 200
Piton131313: checks 
*** FLOP *** [4s Jd 8h]
insomniac_jc: checks 
Piton131313: checks 
malik_msk: bets 575
toitoitoi111: calls 575
insomniac_jc: folds 
Piton131313: calls 575
*** TURN *** [4s Jd 8h] [8s]
Piton131313: checks 
malik_msk: checks 
toitoitoi111: checks 
*** RIVER *** [4s Jd 8h 8s] [2s]
Piton131313: bets 2200
malik_msk: folds 
toitoitoi111: calls 2200
*** SHOW DOWN ***
Piton131313: shows [8c 6c] (three of a kind, Eights)
toitoitoi111: shows [As 8d] (three of a kind, Eights - Ace kicker)
toitoitoi111 collected 8175 from pot
*** SUMMARY ***
Total pot 8175 | Rake 0 
Board [4s Jd 8h 8s 2s]
Seat 1: Piton131313 (big blind) showed [8c 6c] and lost with three of a kind, Eights
Seat 2: Killererin folded before Flop (didn't bet)
Seat 3: malik_msk folded on the River
Seat 4: baztack folded before Flop (didn't bet)
Seat 5: kruiiser folded before Flop (didn't bet)
Seat 6: baloobaloo00 folded before Flop (didn't bet)
Seat 7: miquelCdP folded before Flop (didn't bet)
Seat 8: toitoitoi111 (button) showed [As 8d] and won (8175) with three of a kind, Eights
Seat 9: insomniac_jc (small blind) folded on the Flop



PokerStars Game #70067649408: Tournament #545010286, $5.00+$0.50 USD Hold'em No Limit - Level XIII (200/400) - 2011/11/05 19:19:25 MSK [2011/11/05 11:19:25 ET]
Table '545010286 77' 9-max Seat #9 is the button
Seat 1: Piton131313 (13670 in chips) 
Seat 2: Killererin (30163 in chips) 
Seat 3: malik_msk (35965 in chips) 
Seat 4: baztack (11055 in chips) 
Seat 5: kruiiser (13829 in chips) 
Seat 6: baloobaloo00 (6796 in chips) 
Seat 7: miquelCdP (27622 in chips) 
Seat 8: toitoitoi111 (14005 in chips) 
Seat 9: insomniac_jc (3776 in chips) 
Piton131313: posts the ante 50
Killererin: posts the ante 50
malik_msk: posts the ante 50
baztack: posts the ante 50
kruiiser: posts the ante 50
baloobaloo00: posts the ante 50
miquelCdP: posts the ante 50
toitoitoi111: posts the ante 50
insomniac_jc: posts the ante 50
Piton131313: posts small blind 200
Killererin: posts big blind 400
*** HOLE CARDS ***
Dealt to malik_msk [2d 2c]
malik_msk: folds 
baztack: folds 
kruiiser: folds 
baloobaloo00: folds 
miquelCdP: calls 400
toitoitoi111: folds 
insomniac_jc: folds 
Piton131313: calls 200
Killererin: checks 
*** FLOP *** [Th 5h Qd]
Piton131313: checks 
Killererin: checks 
miquelCdP: bets 800
Piton131313: folds 
Killererin: calls 800
*** TURN *** [Th 5h Qd] [3d]
Killererin: checks 
miquelCdP: checks 
*** RIVER *** [Th 5h Qd 3d] [Jh]
Killererin: checks 
miquelCdP: checks 
*** SHOW DOWN ***
Killererin: shows [5d 4c] (a pair of Fives)
miquelCdP: mucks hand 
Killererin collected 3250 from pot
*** SUMMARY ***
Total pot 3250 | Rake 0 
Board [Th 5h Qd 3d Jh]
Seat 1: Piton131313 (small blind) folded on the Flop
Seat 2: Killererin (big blind) showed [5d 4c] and won (3250) with a pair of Fives
Seat 3: malik_msk folded before Flop (didn't bet)
Seat 4: baztack folded before Flop (didn't bet)
Seat 5: kruiiser folded before Flop (didn't bet)
Seat 6: baloobaloo00 folded before Flop (didn't bet)
Seat 7: miquelCdP mucked [2s Ac]
Seat 8: toitoitoi111 folded before Flop (didn't bet)
Seat 9: insomniac_jc (button) folded before Flop (didn't bet)



PokerStars Game #70067687217: Tournament #545010286, $5.00+$0.50 USD Hold'em No Limit - Level XIII (200/400) - 2011/11/05 19:20:13 MSK [2011/11/05 11:20:13 ET]
Table '545010286 77' 9-max Seat #1 is the button
Seat 1: Piton131313 (13220 in chips) 
Seat 2: Killererin (32163 in chips) 
Seat 3: malik_msk (35915 in chips) 
Seat 4: baztack (11005 in chips) 
Seat 5: kruiiser (13779 in chips) 
Seat 6: baloobaloo00 (6746 in chips) 
Seat 7: miquelCdP (26372 in chips) 
Seat 8: toitoitoi111 (13955 in chips) 
Seat 9: insomniac_jc (3726 in chips) 
Piton131313: posts the ante 50
Killererin: posts the ante 50
malik_msk: posts the ante 50
baztack: posts the ante 50
kruiiser: posts the ante 50
baloobaloo00: posts the ante 50
miquelCdP: posts the ante 50
toitoitoi111: posts the ante 50
insomniac_jc: posts the ante 50
Killererin: posts small blind 200
malik_msk: posts big blind 400
*** HOLE CARDS ***
Dealt to malik_msk [Ah Ts]
baztack: folds 
kruiiser: raises 712 to 1112
baloobaloo00: folds 
miquelCdP: folds 
toitoitoi111: folds 
insomniac_jc: folds 
Piton131313: folds 
Killererin: calls 912
malik_msk: calls 712
*** FLOP *** [7h Kh 6h]
Killererin: checks 
malik_msk: bets 2000
kruiiser: folds 
Killererin: folds 
Uncalled bet (2000) returned to malik_msk
malik_msk collected 3786 from pot
malik_msk: doesn't show hand 
*** SUMMARY ***
Total pot 3786 | Rake 0 
Board [7h Kh 6h]
Seat 1: Piton131313 (button) folded before Flop (didn't bet)
Seat 2: Killererin (small blind) folded on the Flop
Seat 3: malik_msk (big blind) collected (3786)
Seat 4: baztack folded before Flop (didn't bet)
Seat 5: kruiiser folded on the Flop
Seat 6: baloobaloo00 folded before Flop (didn't bet)
Seat 7: miquelCdP folded before Flop (didn't bet)
Seat 8: toitoitoi111 folded before Flop (didn't bet)
Seat 9: insomniac_jc folded before Flop (didn't bet)



PokerStars Game #70067722073: Tournament #545010286, $5.00+$0.50 USD Hold'em No Limit - Level XIII (200/400) - 2011/11/05 19:20:57 MSK [2011/11/05 11:20:57 ET]
Table '545010286 77' 9-max Seat #2 is the button
Seat 1: Piton131313 (13170 in chips) 
Seat 2: Killererin (31001 in chips) 
Seat 3: malik_msk (38539 in chips) 
Seat 4: baztack (10955 in chips) 
Seat 5: kruiiser (12617 in chips) 
Seat 6: baloobaloo00 (6696 in chips) 
Seat 7: miquelCdP (26322 in chips) 
Seat 8: toitoitoi111 (13905 in chips) 
Seat 9: insomniac_jc (3676 in chips) 
Piton131313: posts the ante 50
Killererin: posts the ante 50
malik_msk: posts the ante 50
baztack: posts the ante 50
kruiiser: posts the ante 50
baloobaloo00: posts the ante 50
miquelCdP: posts the ante 50
toitoitoi111: posts the ante 50
insomniac_jc: posts the ante 50
malik_msk: posts small blind 200
baztack: posts big blind 400
*** HOLE CARDS ***
Dealt to malik_msk [7c As]
kruiiser: folds 
baloobaloo00: folds 
miquelCdP: folds 
toitoitoi111: calls 400
insomniac_jc: folds 
Piton131313: raises 880 to 1280
Killererin: folds 
malik_msk: folds 
baztack: folds 
toitoitoi111: folds 
Uncalled bet (880) returned to Piton131313
Piton131313 collected 1850 from pot
*** SUMMARY ***
Total pot 1850 | Rake 0 
Seat 1: Piton131313 collected (1850)
Seat 2: Killererin (button) folded before Flop (didn't bet)
Seat 3: malik_msk (small blind) folded before Flop
Seat 4: baztack (big blind) folded before Flop
Seat 5: kruiiser folded before Flop (didn't bet)
Seat 6: baloobaloo00 folded before Flop (didn't bet)
Seat 7: miquelCdP folded before Flop (didn't bet)
Seat 8: toitoitoi111 folded before Flop
Seat 9: insomniac_jc folded before Flop (didn't bet)



PokerStars Game #70067749964: Tournament #545010286, $5.00+$0.50 USD Hold'em No Limit - Level XIII (200/400) - 2011/11/05 19:21:33 MSK [2011/11/05 11:21:33 ET]
Table '545010286 77' 9-max Seat #3 is the button
Seat 1: Piton131313 (14570 in chips) 
Seat 2: Killererin (30951 in chips) 
Seat 3: malik_msk (38289 in chips) 
Seat 4: baztack (10505 in chips) 
Seat 5: kruiiser (12567 in chips) 
Seat 6: baloobaloo00 (6646 in chips) 
Seat 7: miquelCdP (26272 in chips) 
Seat 8: toitoitoi111 (13455 in chips) 
Seat 9: insomniac_jc (3626 in chips) 
Piton131313: posts the ante 50
Killererin: posts the ante 50
malik_msk: posts the ante 50
baztack: posts the ante 50
kruiiser: posts the ante 50
baloobaloo00: posts the ante 50
miquelCdP: posts the ante 50
toitoitoi111: posts the ante 50
insomniac_jc: posts the ante 50
baztack: posts small blind 200
kruiiser: posts big blind 400
*** HOLE CARDS ***
Dealt to malik_msk [4d 5h]
baloobaloo00: folds 
miquelCdP: folds 
toitoitoi111: folds 
insomniac_jc: folds 
Piton131313: folds 
Killererin: raises 400 to 800
malik_msk: folds 
baztack: folds 
kruiiser: calls 400
*** FLOP *** [Tc Kh Th]
kruiiser: bets 1200
Killererin: folds 
Uncalled bet (1200) returned to kruiiser
kruiiser collected 2250 from pot
kruiiser: doesn't show hand 
*** SUMMARY ***
Total pot 2250 | Rake 0 
Board [Tc Kh Th]
Seat 1: Piton131313 folded before Flop (didn't bet)
Seat 2: Killererin folded on the Flop
Seat 3: malik_msk (button) folded before Flop (didn't bet)
Seat 4: baztack (small blind) folded before Flop
Seat 5: kruiiser (big blind) collected (2250)
Seat 6: baloobaloo00 folded before Flop (didn't bet)
Seat 7: miquelCdP folded before Flop (didn't bet)
Seat 8: toitoitoi111 folded before Flop (didn't bet)
Seat 9: insomniac_jc folded before Flop (didn't bet)



PokerStars Game #70067779979: Tournament #545010286, $5.00+$0.50 USD Hold'em No Limit - Level XIII (200/400) - 2011/11/05 19:22:09 MSK [2011/11/05 11:22:09 ET]
Table '545010286 77' 9-max Seat #4 is the button
Seat 1: Piton131313 (14520 in chips) 
Seat 2: Killererin (30101 in chips) 
Seat 3: malik_msk (38239 in chips) 
Seat 4: baztack (10255 in chips) 
Seat 5: kruiiser (13967 in chips) 
Seat 6: baloobaloo00 (6596 in chips) 
Seat 7: miquelCdP (26222 in chips) 
Seat 8: toitoitoi111 (13405 in chips) 
Seat 9: insomniac_jc (3576 in chips) 
Piton131313: posts the ante 50
Killererin: posts the ante 50
malik_msk: posts the ante 50
baztack: posts the ante 50
kruiiser: posts the ante 50
baloobaloo00: posts the ante 50
miquelCdP: posts the ante 50
toitoitoi111: posts the ante 50
insomniac_jc: posts the ante 50
kruiiser: posts small blind 200
baloobaloo00: posts big blind 400
*** HOLE CARDS ***
Dealt to malik_msk [4d 4s]
miquelCdP: calls 400
toitoitoi111: folds 
insomniac_jc: folds 
Piton131313: folds 
Killererin: calls 400
malik_msk: calls 400
baztack: raises 800 to 1200
kruiiser: folds 
baloobaloo00: folds 
miquelCdP: calls 800
Killererin: calls 800
malik_msk: calls 800
*** FLOP *** [Ad Jc 5d]
miquelCdP: checks 
Killererin: checks 
malik_msk: checks 
baztack: bets 2855
miquelCdP: folds 
Killererin: calls 2855
malik_msk: folds 
*** TURN *** [Ad Jc 5d] [Ts]
Killererin: checks 
baztack: bets 6150 and is all-in
Killererin: folds 
Uncalled bet (6150) returned to baztack
baztack collected 11560 from pot
baztack: doesn't show hand 
*** SUMMARY ***
Total pot 11560 | Rake 0 
Board [Ad Jc 5d Ts]
Seat 1: Piton131313 folded before Flop (didn't bet)
Seat 2: Killererin folded on the Turn
Seat 3: malik_msk folded on the Flop
Seat 4: baztack (button) collected (11560)
Seat 5: kruiiser (small blind) folded before Flop
Seat 6: baloobaloo00 (big blind) folded before Flop
Seat 7: miquelCdP folded on the Flop
Seat 8: toitoitoi111 folded before Flop (didn't bet)
Seat 9: insomniac_jc folded before Flop (didn't bet)



PokerStars Game #70067839040: Tournament #545010286, $5.00+$0.50 USD Hold'em No Limit - Level XIII (200/400) - 2011/11/05 19:23:25 MSK [2011/11/05 11:23:25 ET]
Table '545010286 77' 9-max Seat #5 is the button
Seat 1: Piton131313 (14470 in chips) 
Seat 2: Killererin (25996 in chips) 
Seat 3: malik_msk (36989 in chips) 
Seat 4: baztack (17710 in chips) 
Seat 5: kruiiser (13717 in chips) 
Seat 6: baloobaloo00 (6146 in chips) 
Seat 7: miquelCdP (24972 in chips) 
Seat 8: toitoitoi111 (13355 in chips) 
Seat 9: insomniac_jc (3526 in chips) 
Piton131313: posts the ante 50
Killererin: posts the ante 50
malik_msk: posts the ante 50
baztack: posts the ante 50
kruiiser: posts the ante 50
baloobaloo00: posts the ante 50
miquelCdP: posts the ante 50
toitoitoi111: posts the ante 50
insomniac_jc: posts the ante 50
baloobaloo00: posts small blind 200
miquelCdP: posts big blind 400
*** HOLE CARDS ***
Dealt to malik_msk [Js 7s]
toitoitoi111: calls 400
insomniac_jc: folds 
Piton131313: folds 
Killererin: raises 1200 to 1600
malik_msk: folds 
baztack: folds 
kruiiser: folds 
baloobaloo00: folds 
miquelCdP: folds 
toitoitoi111: calls 1200
*** FLOP *** [9h 2c 6d]
toitoitoi111: checks 
Killererin: bets 2855
toitoitoi111: folds 
Uncalled bet (2855) returned to Killererin
Killererin collected 4250 from pot
Killererin: doesn't show hand 
*** SUMMARY ***
Total pot 4250 | Rake 0 
Board [9h 2c 6d]
Seat 1: Piton131313 folded before Flop (didn't bet)
Seat 2: Killererin collected (4250)
Seat 3: malik_msk folded before Flop (didn't bet)
Seat 4: baztack folded before Flop (didn't bet)
Seat 5: kruiiser (button) folded before Flop (didn't bet)
Seat 6: baloobaloo00 (small blind) folded before Flop
Seat 7: miquelCdP (big blind) folded before Flop
Seat 8: toitoitoi111 folded on the Flop
Seat 9: insomniac_jc folded before Flop (didn't bet)



PokerStars Game #70067878723: Tournament #545010286, $5.00+$0.50 USD Hold'em No Limit - Level XIII (200/400) - 2011/11/05 19:24:15 MSK [2011/11/05 11:24:15 ET]
Table '545010286 77' 9-max Seat #6 is the button
Seat 1: Piton131313 (14420 in chips) 
Seat 2: Killererin (28596 in chips) 
Seat 3: malik_msk (36939 in chips) 
Seat 4: baztack (17660 in chips) 
Seat 5: kruiiser (13667 in chips) 
Seat 6: baloobaloo00 (5896 in chips) 
Seat 7: miquelCdP (24522 in chips) 
Seat 8: toitoitoi111 (11705 in chips) 
Seat 9: insomniac_jc (3476 in chips) 
Piton131313: posts the ante 50
Killererin: posts the ante 50
malik_msk: posts the ante 50
baztack: posts the ante 50
kruiiser: posts the ante 50
baloobaloo00: posts the ante 50
miquelCdP: posts the ante 50
toitoitoi111: posts the ante 50
insomniac_jc: posts the ante 50
miquelCdP: posts small blind 200
toitoitoi111: posts big blind 400
*** HOLE CARDS ***
Dealt to malik_msk [4h 3h]
insomniac_jc: folds 
Piton131313: raises 480 to 880
Killererin: folds 
malik_msk: calls 880
baztack: folds 
kruiiser: folds 
baloobaloo00: calls 880
miquelCdP: folds 
toitoitoi111: folds 
*** FLOP *** [5s 2d 8c]
Piton131313: bets 2000
malik_msk: calls 2000
baloobaloo00: folds 
*** TURN *** [5s 2d 8c] [5d]
Piton131313: checks 
malik_msk: bets 5200
Piton131313: folds 
Uncalled bet (5200) returned to malik_msk
malik_msk collected 7690 from pot
malik_msk: doesn't show hand 
*** SUMMARY ***
Total pot 7690 | Rake 0 
Board [5s 2d 8c 5d]
Seat 1: Piton131313 folded on the Turn
Seat 2: Killererin folded before Flop (didn't bet)
Seat 3: malik_msk collected (7690)
Seat 4: baztack folded before Flop (didn't bet)
Seat 5: kruiiser folded before Flop (didn't bet)
Seat 6: baloobaloo00 (button) folded on the Flop
Seat 7: miquelCdP (small blind) folded before Flop
Seat 8: toitoitoi111 (big blind) folded before Flop
Seat 9: insomniac_jc folded before Flop (didn't bet)



PokerStars Game #70067929820: Tournament #545010286, $5.00+$0.50 USD Hold'em No Limit - Level XIII (200/400) - 2011/11/05 19:25:20 MSK [2011/11/05 11:25:20 ET]
Table '545010286 77' 9-max Seat #7 is the button
Seat 1: Piton131313 (11490 in chips) 
Seat 2: Killererin (28546 in chips) 
Seat 3: malik_msk (41699 in chips) 
Seat 4: baztack (17610 in chips) 
Seat 5: kruiiser (13617 in chips) 
Seat 6: baloobaloo00 (4966 in chips) 
Seat 7: miquelCdP (24272 in chips) 
Seat 8: toitoitoi111 (11255 in chips) 
Seat 9: insomniac_jc (3426 in chips) 
Piton131313: posts the ante 50
Killererin: posts the ante 50
malik_msk: posts the ante 50
baztack: posts the ante 50
kruiiser: posts the ante 50
baloobaloo00: posts the ante 50
miquelCdP: posts the ante 50
toitoitoi111: posts the ante 50
insomniac_jc: posts the ante 50
toitoitoi111: posts small blind 200
insomniac_jc: posts big blind 400
*** HOLE CARDS ***
Dealt to malik_msk [5c 8h]
Piton131313: folds 
Killererin: raises 400 to 800
malik_msk: folds 
baztack: folds 
kruiiser: folds 
baloobaloo00: folds 
miquelCdP: folds 
toitoitoi111: calls 600
insomniac_jc: folds 
*** FLOP *** [2s 8c 5d]
toitoitoi111: checks 
Killererin: checks 
*** TURN *** [2s 8c 5d] [Jd]
toitoitoi111: bets 400
Killererin: raises 1200 to 1600
toitoitoi111: folds 
Uncalled bet (1200) returned to Killererin
Killererin collected 3250 from pot
Killererin: doesn't show hand 
*** SUMMARY ***
Total pot 3250 | Rake 0 
Board [2s 8c 5d Jd]
Seat 1: Piton131313 folded before Flop (didn't bet)
Seat 2: Killererin collected (3250)
Seat 3: malik_msk folded before Flop (didn't bet)
Seat 4: baztack folded before Flop (didn't bet)
Seat 5: kruiiser folded before Flop (didn't bet)
Seat 6: baloobaloo00 folded before Flop (didn't bet)
Seat 7: miquelCdP (button) folded before Flop (didn't bet)
Seat 8: toitoitoi111 (small blind) folded on the Turn
Seat 9: insomniac_jc (big blind) folded before Flop



PokerStars Game #70067987502: Tournament #545010286, $5.00+$0.50 USD Hold'em No Limit - Level XIV (250/500) - 2011/11/05 19:26:32 MSK [2011/11/05 11:26:32 ET]
Table '545010286 77' 9-max Seat #8 is the button
Seat 1: Piton131313 (11440 in chips) 
Seat 2: Killererin (30546 in chips) 
Seat 3: malik_msk (41649 in chips) 
Seat 4: baztack (17560 in chips) 
Seat 5: kruiiser (13567 in chips) 
Seat 6: baloobaloo00 (4916 in chips) 
Seat 7: miquelCdP (24222 in chips) 
Seat 8: toitoitoi111 (10005 in chips) 
Seat 9: insomniac_jc (2976 in chips) 
Piton131313: posts the ante 60
Killererin: posts the ante 60
malik_msk: posts the ante 60
baztack: posts the ante 60
kruiiser: posts the ante 60
baloobaloo00: posts the ante 60
miquelCdP: posts the ante 60
toitoitoi111: posts the ante 60
insomniac_jc: posts the ante 60
insomniac_jc: posts small blind 250
Piton131313: posts big blind 500
*** HOLE CARDS ***
Dealt to malik_msk [4d Kc]
Killererin: folds 
malik_msk: folds 
toitoitoi111 said, "fi d idiot"
baztack: folds 
kruiiser: folds 
baloobaloo00: folds 
miquelCdP: calls 500
toitoitoi111: folds 
insomniac_jc: calls 250
Piton131313: checks 
*** FLOP *** [4c 9c Jh]
insomniac_jc: checks 
Piton131313: checks 
miquelCdP: bets 1000
insomniac_jc: folds 
Piton131313: calls 1000
*** TURN *** [4c 9c Jh] [4s]
Piton131313: checks 
miquelCdP: bets 4000
Piton131313: calls 4000
*** RIVER *** [4c 9c Jh 4s] [8s]
Piton131313: checks 
miquelCdP: checks 
*** SHOW DOWN ***
Piton131313: shows [9h Td] (two pair, Nines and Fours)
miquelCdP: mucks hand 
Piton131313 collected 12040 from pot
*** SUMMARY ***
Total pot 12040 | Rake 0 
Board [4c 9c Jh 4s 8s]
Seat 1: Piton131313 (big blind) showed [9h Td] and won (12040) with two pair, Nines and Fours
Seat 2: Killererin folded before Flop (didn't bet)
Seat 3: malik_msk folded before Flop (didn't bet)
Seat 4: baztack folded before Flop (didn't bet)
Seat 5: kruiiser folded before Flop (didn't bet)
Seat 6: baloobaloo00 folded before Flop (didn't bet)
Seat 7: miquelCdP mucked [8d Ks]
Seat 8: toitoitoi111 (button) folded before Flop (didn't bet)
Seat 9: insomniac_jc (small blind) folded on the Flop



PokerStars Game #70068042720: Tournament #545010286, $5.00+$0.50 USD Hold'em No Limit - Level XIV (250/500) - 2011/11/05 19:27:41 MSK [2011/11/05 11:27:41 ET]
Table '545010286 77' 9-max Seat #9 is the button
Seat 1: Piton131313 (17920 in chips) 
Seat 2: Killererin (30486 in chips) 
Seat 3: malik_msk (41589 in chips) 
Seat 4: baztack (17500 in chips) 
Seat 5: kruiiser (13507 in chips) 
Seat 6: baloobaloo00 (4856 in chips) 
Seat 7: miquelCdP (18662 in chips) 
Seat 8: toitoitoi111 (9945 in chips) 
Seat 9: insomniac_jc (2416 in chips) 
Piton131313: posts the ante 60
Killererin: posts the ante 60
malik_msk: posts the ante 60
baztack: posts the ante 60
kruiiser: posts the ante 60
baloobaloo00: posts the ante 60
miquelCdP: posts the ante 60
toitoitoi111: posts the ante 60
insomniac_jc: posts the ante 60
Piton131313: posts small blind 250
Killererin: posts big blind 500
*** HOLE CARDS ***
Dealt to malik_msk [Qs Ac]
malik_msk: raises 500 to 1000
baztack: folds 
kruiiser: folds 
baloobaloo00: folds 
miquelCdP: folds 
toitoitoi111: folds 
insomniac_jc: calls 1000
Piton131313: folds 
Killererin: folds 
*** FLOP *** [Th As 8c]
malik_msk: bets 1000
insomniac_jc: raises 356 to 1356 and is all-in
malik_msk: calls 356
*** TURN *** [Th As 8c] [7c]
*** RIVER *** [Th As 8c 7c] [8h]
*** SHOW DOWN ***
malik_msk: shows [Qs Ac] (two pair, Aces and Eights)
insomniac_jc: shows [Ad Qc] (two pair, Aces and Eights)
malik_msk collected 3001 from pot
insomniac_jc collected 3001 from pot
*** SUMMARY ***
Total pot 6002 | Rake 0 
Board [Th As 8c 7c 8h]
Seat 1: Piton131313 (small blind) folded before Flop
Seat 2: Killererin (big blind) folded before Flop
Seat 3: malik_msk showed [Qs Ac] and won (3001) with two pair, Aces and Eights
Seat 4: baztack folded before Flop (didn't bet)
Seat 5: kruiiser folded before Flop (didn't bet)
Seat 6: baloobaloo00 folded before Flop (didn't bet)
Seat 7: miquelCdP folded before Flop (didn't bet)
Seat 8: toitoitoi111 folded before Flop (didn't bet)
Seat 9: insomniac_jc (button) showed [Ad Qc] and won (3001) with two pair, Aces and Eights



PokerStars Game #70068080367: Tournament #545010286, $5.00+$0.50 USD Hold'em No Limit - Level XIV (250/500) - 2011/11/05 19:28:29 MSK [2011/11/05 11:28:29 ET]
Table '545010286 77' 9-max Seat #1 is the button
Seat 1: Piton131313 (17610 in chips) 
Seat 2: Killererin (29926 in chips) 
Seat 3: malik_msk (42174 in chips) 
Seat 4: baztack (17440 in chips) 
Seat 5: kruiiser (13447 in chips) 
Seat 6: baloobaloo00 (4796 in chips) 
Seat 7: miquelCdP (18602 in chips) 
Seat 8: toitoitoi111 (9885 in chips) 
Seat 9: insomniac_jc (3001 in chips) 
Piton131313: posts the ante 60
Killererin: posts the ante 60
malik_msk: posts the ante 60
baztack: posts the ante 60
kruiiser: posts the ante 60
baloobaloo00: posts the ante 60
miquelCdP: posts the ante 60
toitoitoi111: posts the ante 60
insomniac_jc: posts the ante 60
Killererin: posts small blind 250
malik_msk: posts big blind 500
*** HOLE CARDS ***
Dealt to malik_msk [8d 3h]
baztack: folds 
kruiiser: folds 
baloobaloo00: folds 
miquelCdP: folds 
toitoitoi111: calls 500
insomniac_jc: folds 
Piton131313: folds 
Killererin: folds 
malik_msk: checks 
*** FLOP *** [9d 2h 6c]
malik_msk: checks 
toitoitoi111: checks 
*** TURN *** [9d 2h 6c] [9c]
malik_msk: bets 500
toitoitoi111: calls 500
*** RIVER *** [9d 2h 6c 9c] [Kh]
malik_msk: checks 
toitoitoi111: bets 1000
malik_msk: folds 
Uncalled bet (1000) returned to toitoitoi111
toitoitoi111 collected 2790 from pot
toitoitoi111: doesn't show hand 
*** SUMMARY ***
Total pot 2790 | Rake 0 
Board [9d 2h 6c 9c Kh]
Seat 1: Piton131313 (button) folded before Flop (didn't bet)
Seat 2: Killererin (small blind) folded before Flop
Seat 3: malik_msk (big blind) folded on the River
Seat 4: baztack folded before Flop (didn't bet)
Seat 5: kruiiser folded before Flop (didn't bet)
Seat 6: baloobaloo00 folded before Flop (didn't bet)
Seat 7: miquelCdP folded before Flop (didn't bet)
Seat 8: toitoitoi111 collected (2790)
Seat 9: insomniac_jc folded before Flop (didn't bet)



PokerStars Game #70068115816: Tournament #545010286, $5.00+$0.50 USD Hold'em No Limit - Level XIV (250/500) - 2011/11/05 19:29:14 MSK [2011/11/05 11:29:14 ET]
Table '545010286 77' 9-max Seat #2 is the button
Seat 1: Piton131313 (17550 in chips) 
Seat 2: Killererin (29616 in chips) 
Seat 3: malik_msk (41114 in chips) 
Seat 4: baztack (17380 in chips) 
Seat 5: kruiiser (13387 in chips) 
Seat 6: baloobaloo00 (4736 in chips) 
Seat 7: miquelCdP (18542 in chips) 
Seat 8: toitoitoi111 (11615 in chips) 
Seat 9: insomniac_jc (2941 in chips) 
Piton131313: posts the ante 60
Killererin: posts the ante 60
malik_msk: posts the ante 60
baztack: posts the ante 60
kruiiser: posts the ante 60
baloobaloo00: posts the ante 60
miquelCdP: posts the ante 60
toitoitoi111: posts the ante 60
insomniac_jc: posts the ante 60
malik_msk: posts small blind 250
baztack: posts big blind 500
*** HOLE CARDS ***
Dealt to malik_msk [Td Js]
kruiiser: folds 
baloobaloo00: folds 
miquelCdP: folds 
toitoitoi111: folds 
insomniac_jc: folds 
Piton131313: folds 
Killererin: raises 500 to 1000
malik_msk: calls 750
baztack: folds 
*** FLOP *** [Ad 5h Qd]
malik_msk: checks 
Killererin: checks 
*** TURN *** [Ad 5h Qd] [3d]
malik_msk: checks 
Killererin: bets 1000
malik_msk: calls 1000
*** RIVER *** [Ad 5h Qd 3d] [7h]
malik_msk: checks 
Killererin: checks 
*** SHOW DOWN ***
malik_msk: shows [Td Js] (high card Ace)
Killererin: shows [Qc Kh] (a pair of Queens)
Killererin collected 5040 from pot
*** SUMMARY ***
Total pot 5040 | Rake 0 
Board [Ad 5h Qd 3d 7h]
Seat 1: Piton131313 folded before Flop (didn't bet)
Seat 2: Killererin (button) showed [Qc Kh] and won (5040) with a pair of Queens
Seat 3: malik_msk (small blind) showed [Td Js] and lost with high card Ace
Seat 4: baztack (big blind) folded before Flop
Seat 5: kruiiser folded before Flop (didn't bet)
Seat 6: baloobaloo00 folded before Flop (didn't bet)
Seat 7: miquelCdP folded before Flop (didn't bet)
Seat 8: toitoitoi111 folded before Flop (didn't bet)
Seat 9: insomniac_jc folded before Flop (didn't bet)



PokerStars Game #70068150017: Tournament #545010286, $5.00+$0.50 USD Hold'em No Limit - Level XIV (250/500) - 2011/11/05 19:29:56 MSK [2011/11/05 11:29:56 ET]
Table '545010286 77' 9-max Seat #3 is the button
Seat 1: Piton131313 (17490 in chips) 
Seat 2: Killererin (32596 in chips) 
Seat 3: malik_msk (39054 in chips) 
Seat 4: baztack (16820 in chips) 
Seat 5: kruiiser (13327 in chips) 
Seat 6: baloobaloo00 (4676 in chips) 
Seat 7: miquelCdP (18482 in chips) 
Seat 8: toitoitoi111 (11555 in chips) 
Seat 9: insomniac_jc (2881 in chips) 
Piton131313: posts the ante 60
Killererin: posts the ante 60
malik_msk: posts the ante 60
baztack: posts the ante 60
kruiiser: posts the ante 60
baloobaloo00: posts the ante 60
miquelCdP: posts the ante 60
toitoitoi111: posts the ante 60
insomniac_jc: posts the ante 60
baztack: posts small blind 250
kruiiser: posts big blind 500
*** HOLE CARDS ***
Dealt to malik_msk [9d 3c]
baloobaloo00: folds 
miquelCdP: folds 
toitoitoi111: folds 
insomniac_jc: folds 
Piton131313: folds 
Killererin: raises 500 to 1000
malik_msk: folds 
baztack: folds 
kruiiser: calls 500
*** FLOP *** [Ts 2d 8c]
kruiiser: bets 1500
Killererin: folds 
Uncalled bet (1500) returned to kruiiser
kruiiser collected 2790 from pot
*** SUMMARY ***
Total pot 2790 | Rake 0 
Board [Ts 2d 8c]
Seat 1: Piton131313 folded before Flop (didn't bet)
Seat 2: Killererin folded on the Flop
Seat 3: malik_msk (button) folded before Flop (didn't bet)
Seat 4: baztack (small blind) folded before Flop
Seat 5: kruiiser (big blind) collected (2790)
Seat 6: baloobaloo00 folded before Flop (didn't bet)
Seat 7: miquelCdP folded before Flop (didn't bet)
Seat 8: toitoitoi111 folded before Flop (didn't bet)
Seat 9: insomniac_jc folded before Flop (didn't bet)



PokerStars Game #70068177576: Tournament #545010286, $5.00+$0.50 USD Hold'em No Limit - Level XIV (250/500) - 2011/11/05 19:30:31 MSK [2011/11/05 11:30:31 ET]
Table '545010286 77' 9-max Seat #4 is the button
Seat 1: Piton131313 (17430 in chips) 
Seat 2: Killererin (31536 in chips) 
Seat 3: malik_msk (38994 in chips) 
Seat 4: baztack (16510 in chips) 
Seat 5: kruiiser (15057 in chips) 
Seat 6: baloobaloo00 (4616 in chips) 
Seat 7: miquelCdP (18422 in chips) 
Seat 8: toitoitoi111 (11495 in chips) 
Seat 9: insomniac_jc (2821 in chips) 
Piton131313: posts the ante 60
Killererin: posts the ante 60
malik_msk: posts the ante 60
baztack: posts the ante 60
kruiiser: posts the ante 60
baloobaloo00: posts the ante 60
miquelCdP: posts the ante 60
toitoitoi111: posts the ante 60
insomniac_jc: posts the ante 60
kruiiser: posts small blind 250
baloobaloo00: posts big blind 500
*** HOLE CARDS ***
Dealt to malik_msk [Td Ad]
miquelCdP: calls 500
toitoitoi111: folds 
insomniac_jc: folds 
Piton131313: folds 
Killererin: folds 
malik_msk: raises 500 to 1000
baztack: folds 
kruiiser: folds 
baloobaloo00: folds 
miquelCdP: calls 500
*** FLOP *** [Jd 6h 7c]
miquelCdP: bets 2000
malik_msk: raises 2500 to 4500
miquelCdP: calls 2500
*** TURN *** [Jd 6h 7c] [Ts]
miquelCdP: bets 12862 and is all-in
malik_msk: calls 12862
*** RIVER *** [Jd 6h 7c Ts] [9s]
*** SHOW DOWN ***
miquelCdP: shows [9c 8c] (a straight, Seven to Jack)
malik_msk: shows [Td Ad] (a pair of Tens)
miquelCdP collected 38014 from pot
*** SUMMARY ***
Total pot 38014 | Rake 0 
Board [Jd 6h 7c Ts 9s]
Seat 1: Piton131313 folded before Flop (didn't bet)
Seat 2: Killererin folded before Flop (didn't bet)
Seat 3: malik_msk showed [Td Ad] and lost with a pair of Tens
Seat 4: baztack (button) folded before Flop (didn't bet)
Seat 5: kruiiser (small blind) folded before Flop
Seat 6: baloobaloo00 (big blind) folded before Flop
Seat 7: miquelCdP showed [9c 8c] and won (38014) with a straight, Seven to Jack
Seat 8: toitoitoi111 folded before Flop (didn't bet)
Seat 9: insomniac_jc folded before Flop (didn't bet)



PokerStars Game #70068245518: Tournament #545010286, $5.00+$0.50 USD Hold'em No Limit - Level XIV (250/500) - 2011/11/05 19:31:55 MSK [2011/11/05 11:31:55 ET]
Table '545010286 77' 9-max Seat #5 is the button
Seat 1: Piton131313 (17370 in chips) 
Seat 2: Killererin (31476 in chips) 
Seat 3: malik_msk (20572 in chips) 
Seat 4: baztack (16450 in chips) 
Seat 5: kruiiser (14747 in chips) 
Seat 6: baloobaloo00 (4056 in chips) 
Seat 7: miquelCdP (38014 in chips) 
Seat 8: toitoitoi111 (11435 in chips) 
Seat 9: insomniac_jc (2761 in chips) 
Piton131313: posts the ante 60
Killererin: posts the ante 60
malik_msk: posts the ante 60
baztack: posts the ante 60
kruiiser: posts the ante 60
baloobaloo00: posts the ante 60
miquelCdP: posts the ante 60
toitoitoi111: posts the ante 60
insomniac_jc: posts the ante 60
baloobaloo00: posts small blind 250
miquelCdP: posts big blind 500
*** HOLE CARDS ***
Dealt to malik_msk [3s As]
toitoitoi111: folds 
insomniac_jc: folds 
Piton131313: folds 
Killererin: raises 500 to 1000
malik_msk: calls 1000
baztack: folds 
kruiiser: folds 
baloobaloo00: folds 
miquelCdP: calls 500
*** FLOP *** [4s Ah 6c]
miquelCdP: checks 
Killererin: bets 2000
malik_msk: raises 17512 to 19512 and is all-in
miquelCdP: folds 
Killererin: folds 
Uncalled bet (17512) returned to malik_msk
malik_msk collected 7790 from pot
malik_msk: doesn't show hand 
*** SUMMARY ***
Total pot 7790 | Rake 0 
Board [4s Ah 6c]
Seat 1: Piton131313 folded before Flop (didn't bet)
Seat 2: Killererin folded on the Flop
Seat 3: malik_msk collected (7790)
Seat 4: baztack folded before Flop (didn't bet)
Seat 5: kruiiser (button) folded before Flop (didn't bet)
Seat 6: baloobaloo00 (small blind) folded before Flop
Seat 7: miquelCdP (big blind) folded on the Flop
Seat 8: toitoitoi111 folded before Flop (didn't bet)
Seat 9: insomniac_jc folded before Flop (didn't bet)



PokerStars Game #70068293349: Tournament #545010286, $5.00+$0.50 USD Hold'em No Limit - Level XIV (250/500) - 2011/11/05 19:32:55 MSK [2011/11/05 11:32:55 ET]
Table '545010286 77' 9-max Seat #6 is the button
Seat 1: Piton131313 (17310 in chips) 
Seat 2: Killererin (28416 in chips) 
Seat 3: malik_msk (25302 in chips) 
Seat 4: baztack (16390 in chips) 
Seat 5: kruiiser (14687 in chips) 
Seat 6: baloobaloo00 (3746 in chips) 
Seat 7: miquelCdP (36954 in chips) 
Seat 8: toitoitoi111 (11375 in chips) 
Seat 9: insomniac_jc (2701 in chips) 
Piton131313: posts the ante 60
Killererin: posts the ante 60
malik_msk: posts the ante 60
baztack: posts the ante 60
kruiiser: posts the ante 60
baloobaloo00: posts the ante 60
miquelCdP: posts the ante 60
toitoitoi111: posts the ante 60
insomniac_jc: posts the ante 60
miquelCdP: posts small blind 250
toitoitoi111: posts big blind 500
*** HOLE CARDS ***
Dealt to malik_msk [Ks Ah]
insomniac_jc: folds 
Piton131313: folds 
Killererin: folds 
malik_msk: raises 1500 to 2000
baztack: folds 
kruiiser: folds 
baloobaloo00: folds 
miquelCdP: folds 
toitoitoi111: folds 
Uncalled bet (1500) returned to malik_msk
malik_msk collected 1790 from pot
malik_msk: doesn't show hand 
*** SUMMARY ***
Total pot 1790 | Rake 0 
Seat 1: Piton131313 folded before Flop (didn't bet)
Seat 2: Killererin folded before Flop (didn't bet)
Seat 3: malik_msk collected (1790)
Seat 4: baztack folded before Flop (didn't bet)
Seat 5: kruiiser folded before Flop (didn't bet)
Seat 6: baloobaloo00 (button) folded before Flop (didn't bet)
Seat 7: miquelCdP (small blind) folded before Flop
Seat 8: toitoitoi111 (big blind) folded before Flop
Seat 9: insomniac_jc folded before Flop (didn't bet)



PokerStars Game #70068315223: Tournament #545010286, $5.00+$0.50 USD Hold'em No Limit - Level XIV (250/500) - 2011/11/05 19:33:22 MSK [2011/11/05 11:33:22 ET]
Table '545010286 77' 9-max Seat #7 is the button
Seat 1: Piton131313 (17250 in chips) 
Seat 2: Killererin (28356 in chips) 
Seat 3: malik_msk (26532 in chips) 
Seat 4: baztack (16330 in chips) 
Seat 5: kruiiser (14627 in chips) 
Seat 6: baloobaloo00 (3686 in chips) 
Seat 7: miquelCdP (36644 in chips) 
Seat 8: toitoitoi111 (10815 in chips) 
Seat 9: insomniac_jc (2641 in chips) 
Piton131313: posts the ante 60
Killererin: posts the ante 60
malik_msk: posts the ante 60
baztack: posts the ante 60
kruiiser: posts the ante 60
baloobaloo00: posts the ante 60
miquelCdP: posts the ante 60
toitoitoi111: posts the ante 60
insomniac_jc: posts the ante 60
toitoitoi111: posts small blind 250
insomniac_jc: posts big blind 500
*** HOLE CARDS ***
Dealt to malik_msk [Js 6d]
Piton131313: folds 
Killererin: folds 
malik_msk: folds 
baztack: folds 
kruiiser: folds 
baloobaloo00: folds 
miquelCdP: folds 
toitoitoi111: calls 250
insomniac_jc: checks 
*** FLOP *** [3s 8c 7c]
toitoitoi111: bets 1000
insomniac_jc: folds 
Uncalled bet (1000) returned to toitoitoi111
toitoitoi111 collected 1540 from pot
toitoitoi111: doesn't show hand 
*** SUMMARY ***
Total pot 1540 | Rake 0 
Board [3s 8c 7c]
Seat 1: Piton131313 folded before Flop (didn't bet)
Seat 2: Killererin folded before Flop (didn't bet)
Seat 3: malik_msk folded before Flop (didn't bet)
Seat 4: baztack folded before Flop (didn't bet)
Seat 5: kruiiser folded before Flop (didn't bet)
Seat 6: baloobaloo00 folded before Flop (didn't bet)
Seat 7: miquelCdP (button) folded before Flop (didn't bet)
Seat 8: toitoitoi111 (small blind) collected (1540)
Seat 9: insomniac_jc (big blind) folded on the Flop



PokerStars Game #70068343960: Tournament #545010286, $5.00+$0.50 USD Hold'em No Limit - Level XIV (250/500) - 2011/11/05 19:33:58 MSK [2011/11/05 11:33:58 ET]
Table '545010286 77' 9-max Seat #8 is the button
Seat 1: Piton131313 (17190 in chips) 
Seat 2: Killererin (28296 in chips) 
Seat 3: malik_msk (26472 in chips) 
Seat 4: baztack (16270 in chips) 
Seat 5: kruiiser (14567 in chips) 
Seat 6: baloobaloo00 (3626 in chips) 
Seat 7: miquelCdP (36584 in chips) 
Seat 8: toitoitoi111 (11795 in chips) 
Seat 9: insomniac_jc (2081 in chips) 
Piton131313: posts the ante 60
Killererin: posts the ante 60
malik_msk: posts the ante 60
baztack: posts the ante 60
kruiiser: posts the ante 60
baloobaloo00: posts the ante 60
miquelCdP: posts the ante 60
toitoitoi111: posts the ante 60
insomniac_jc: posts the ante 60
insomniac_jc: posts small blind 250
Piton131313: posts big blind 500
*** HOLE CARDS ***
Dealt to malik_msk [Qh 5h]
Killererin: folds 
malik_msk: calls 500
baztack: folds 
kruiiser: folds 
baloobaloo00: folds 
miquelCdP: folds 
toitoitoi111: calls 500
insomniac_jc: calls 250
Piton131313: checks 
*** FLOP *** [Qc 3h Ac]
insomniac_jc: checks 
Piton131313: checks 
malik_msk: bets 500
toitoitoi111: calls 500
insomniac_jc: raises 1021 to 1521 and is all-in
Piton131313: folds 
malik_msk: folds 
toitoitoi111: calls 1021
*** TURN *** [Qc 3h Ac] [Td]
*** RIVER *** [Qc 3h Ac Td] [4s]
*** SHOW DOWN ***
insomniac_jc: shows [As 5s] (a pair of Aces)
toitoitoi111: shows [Ts Ks] (a pair of Tens)
insomniac_jc collected 6082 from pot
*** SUMMARY ***
Total pot 6082 | Rake 0 
Board [Qc 3h Ac Td 4s]
Seat 1: Piton131313 (big blind) folded on the Flop
Seat 2: Killererin folded before Flop (didn't bet)
Seat 3: malik_msk folded on the Flop
Seat 4: baztack folded before Flop (didn't bet)
Seat 5: kruiiser folded before Flop (didn't bet)
Seat 6: baloobaloo00 folded before Flop (didn't bet)
Seat 7: miquelCdP folded before Flop (didn't bet)
Seat 8: toitoitoi111 (button) showed [Ts Ks] and lost with a pair of Tens
Seat 9: insomniac_jc (small blind) showed [As 5s] and won (6082) with a pair of Aces



PokerStars Game #70068391679: Tournament #545010286, $5.00+$0.50 USD Hold'em No Limit - Level XIV (250/500) - 2011/11/05 19:34:57 MSK [2011/11/05 11:34:57 ET]
Table '545010286 77' 9-max Seat #9 is the button
Seat 1: Piton131313 (16630 in chips) 
Seat 2: Killererin (28236 in chips) 
Seat 3: malik_msk (25412 in chips) 
Seat 4: baztack (16210 in chips) 
Seat 5: kruiiser (14507 in chips) 
Seat 6: baloobaloo00 (3566 in chips) 
Seat 7: miquelCdP (36524 in chips) 
Seat 8: toitoitoi111 (9714 in chips) 
Seat 9: insomniac_jc (6082 in chips) 
Piton131313: posts the ante 60
Killererin: posts the ante 60
malik_msk: posts the ante 60
baztack: posts the ante 60
kruiiser: posts the ante 60
baloobaloo00: posts the ante 60
miquelCdP: posts the ante 60
toitoitoi111: posts the ante 60
insomniac_jc: posts the ante 60
Piton131313: posts small blind 250
Killererin: posts big blind 500
*** HOLE CARDS ***
Dealt to malik_msk [Ad 2s]
malik_msk: folds 
baztack: folds 
kruiiser: folds 
baloobaloo00: folds 
miquelCdP: folds 
toitoitoi111: calls 500
insomniac_jc: folds 
Piton131313: folds 
Killererin: checks 
*** FLOP *** [3c 9d Kc]
Killererin: checks 
toitoitoi111: bets 500
Killererin: calls 500
*** TURN *** [3c 9d Kc] [Th]
Killererin: checks 
toitoitoi111: bets 500
Killererin: raises 2000 to 2500
toitoitoi111: calls 2000
*** RIVER *** [3c 9d Kc Th] [6c]
Killererin: bets 3000
toitoitoi111: folds 
Uncalled bet (3000) returned to Killererin
Killererin collected 7790 from pot
Killererin: doesn't show hand 
*** SUMMARY ***
Total pot 7790 | Rake 0 
Board [3c 9d Kc Th 6c]
Seat 1: Piton131313 (small blind) folded before Flop
Seat 2: Killererin (big blind) collected (7790)
Seat 3: malik_msk folded before Flop (didn't bet)
Seat 4: baztack folded before Flop (didn't bet)
Seat 5: kruiiser folded before Flop (didn't bet)
Seat 6: baloobaloo00 folded before Flop (didn't bet)
Seat 7: miquelCdP folded before Flop (didn't bet)
Seat 8: toitoitoi111 folded on the River
Seat 9: insomniac_jc (button) folded before Flop (didn't bet)



PokerStars Game #70068449105: Tournament #545010286, $5.00+$0.50 USD Hold'em No Limit - Level XV (300/600) - 2011/11/05 19:36:08 MSK [2011/11/05 11:36:08 ET]
Table '545010286 77' 9-max Seat #1 is the button
Seat 1: Piton131313 (16320 in chips) 
Seat 2: Killererin (32466 in chips) 
Seat 3: malik_msk (25352 in chips) 
Seat 4: baztack (16150 in chips) 
Seat 5: kruiiser (14447 in chips) 
Seat 6: baloobaloo00 (3506 in chips) 
Seat 7: miquelCdP (36464 in chips) 
Seat 8: toitoitoi111 (6154 in chips) 
Seat 9: insomniac_jc (6022 in chips) 
Piton131313: posts the ante 70
Killererin: posts the ante 70
malik_msk: posts the ante 70
baztack: posts the ante 70
kruiiser: posts the ante 70
baloobaloo00: posts the ante 70
miquelCdP: posts the ante 70
toitoitoi111: posts the ante 70
insomniac_jc: posts the ante 70
Killererin: posts small blind 300
malik_msk: posts big blind 600
*** HOLE CARDS ***
Dealt to malik_msk [Js Ad]
toitoitoi111 said, "dumme sau"
baztack: folds 
kruiiser: folds 
baloobaloo00: folds 
miquelCdP: folds 
toitoitoi111: folds 
insomniac_jc: folds 
Piton131313: folds 
Killererin: raises 600 to 1200
malik_msk: raises 1800 to 3000
Killererin: folds 
Uncalled bet (1800) returned to malik_msk
malik_msk collected 3030 from pot
malik_msk: doesn't show hand 
*** SUMMARY ***
Total pot 3030 | Rake 0 
Seat 1: Piton131313 (button) folded before Flop (didn't bet)
Seat 2: Killererin (small blind) folded before Flop
Seat 3: malik_msk (big blind) collected (3030)
Seat 4: baztack folded before Flop (didn't bet)
Seat 5: kruiiser folded before Flop (didn't bet)
Seat 6: baloobaloo00 folded before Flop (didn't bet)
Seat 7: miquelCdP folded before Flop (didn't bet)
Seat 8: toitoitoi111 folded before Flop (didn't bet)
Seat 9: insomniac_jc folded before Flop (didn't bet)



PokerStars Game #70068488037: Tournament #545010286, $5.00+$0.50 USD Hold'em No Limit - Level XV (300/600) - 2011/11/05 19:36:56 MSK [2011/11/05 11:36:56 ET]
Table '545010286 77' 9-max Seat #2 is the button
Seat 1: Piton131313 (16250 in chips) 
Seat 2: Killererin (31196 in chips) 
Seat 3: malik_msk (27112 in chips) 
Seat 4: baztack (16080 in chips) 
Seat 5: kruiiser (14377 in chips) 
Seat 6: baloobaloo00 (3436 in chips) 
Seat 7: miquelCdP (36394 in chips) 
Seat 8: toitoitoi111 (6084 in chips) 
Seat 9: insomniac_jc (5952 in chips) 
Piton131313: posts the ante 70
Killererin: posts the ante 70
malik_msk: posts the ante 70
baztack: posts the ante 70
kruiiser: posts the ante 70
baloobaloo00: posts the ante 70
miquelCdP: posts the ante 70
toitoitoi111: posts the ante 70
insomniac_jc: posts the ante 70
malik_msk: posts small blind 300
baztack: posts big blind 600
*** HOLE CARDS ***
Dealt to malik_msk [3h Jd]
kruiiser: folds 
baloobaloo00: folds 
miquelCdP: raises 1200 to 1800
toitoitoi111: calls 1800
insomniac_jc: folds 
Piton131313: folds 
Killererin: folds 
malik_msk: folds 
baztack: folds 
*** FLOP *** [7d Ks 7c]
miquelCdP: bets 5400
toitoitoi111: calls 4214 and is all-in
Uncalled bet (1186) returned to miquelCdP
*** TURN *** [7d Ks 7c] [5c]
*** RIVER *** [7d Ks 7c 5c] [2s]
*** SHOW DOWN ***
miquelCdP: shows [Jc Ac] (a pair of Sevens)
toitoitoi111: shows [Qh Qd] (two pair, Queens and Sevens)
toitoitoi111 collected 13558 from pot
*** SUMMARY ***
Total pot 13558 | Rake 0 
Board [7d Ks 7c 5c 2s]
Seat 1: Piton131313 folded before Flop (didn't bet)
Seat 2: Killererin (button) folded before Flop (didn't bet)
Seat 3: malik_msk (small blind) folded before Flop
Seat 4: baztack (big blind) folded before Flop
Seat 5: kruiiser folded before Flop (didn't bet)
Seat 6: baloobaloo00 folded before Flop (didn't bet)
Seat 7: miquelCdP showed [Jc Ac] and lost with a pair of Sevens
Seat 8: toitoitoi111 showed [Qh Qd] and won (13558) with two pair, Queens and Sevens
Seat 9: insomniac_jc folded before Flop (didn't bet)



PokerStars Game #70068528417: Tournament #545010286, $5.00+$0.50 USD Hold'em No Limit - Level XV (300/600) - 2011/11/05 19:37:47 MSK [2011/11/05 11:37:47 ET]
Table '545010286 77' 9-max Seat #3 is the button
Seat 1: Piton131313 (16180 in chips) 
Seat 2: Killererin (31126 in chips) 
Seat 3: malik_msk (26742 in chips) 
Seat 4: baztack (15410 in chips) 
Seat 5: kruiiser (14307 in chips) 
Seat 6: baloobaloo00 (3366 in chips) 
Seat 7: miquelCdP (30310 in chips) 
Seat 8: toitoitoi111 (13558 in chips) 
Seat 9: insomniac_jc (5882 in chips) 
Piton131313: posts the ante 70
Killererin: posts the ante 70
malik_msk: posts the ante 70
baztack: posts the ante 70
kruiiser: posts the ante 70
baloobaloo00: posts the ante 70
miquelCdP: posts the ante 70
toitoitoi111: posts the ante 70
insomniac_jc: posts the ante 70
baztack: posts small blind 300
kruiiser: posts big blind 600
*** HOLE CARDS ***
Dealt to malik_msk [8h Kd]
baloobaloo00: folds 
miquelCdP: folds 
toitoitoi111: folds 
insomniac_jc: folds 
Piton131313: folds 
Killererin: raises 600 to 1200
malik_msk: folds 
baztack: folds 
kruiiser: folds 
Uncalled bet (600) returned to Killererin
Killererin collected 2130 from pot
Killererin: doesn't show hand 
*** SUMMARY ***
Total pot 2130 | Rake 0 
Seat 1: Piton131313 folded before Flop (didn't bet)
Seat 2: Killererin collected (2130)
Seat 3: malik_msk (button) folded before Flop (didn't bet)
Seat 4: baztack (small blind) folded before Flop
Seat 5: kruiiser (big blind) folded before Flop
Seat 6: baloobaloo00 folded before Flop (didn't bet)
Seat 7: miquelCdP folded before Flop (didn't bet)
Seat 8: toitoitoi111 folded before Flop (didn't bet)
Seat 9: insomniac_jc folded before Flop (didn't bet)



PokerStars Game #70068560118: Tournament #545010286, $5.00+$0.50 USD Hold'em No Limit - Level XV (300/600) - 2011/11/05 19:38:26 MSK [2011/11/05 11:38:26 ET]
Table '545010286 77' 9-max Seat #4 is the button
Seat 1: Piton131313 (16110 in chips) 
Seat 2: Killererin (32586 in chips) 
Seat 3: malik_msk (26672 in chips) 
Seat 4: baztack (15040 in chips) 
Seat 5: kruiiser (13637 in chips) 
Seat 6: baloobaloo00 (3296 in chips) 
Seat 7: miquelCdP (30240 in chips) 
Seat 8: toitoitoi111 (13488 in chips) 
Seat 9: insomniac_jc (5812 in chips) 
Piton131313: posts the ante 70
Killererin: posts the ante 70
malik_msk: posts the ante 70
baztack: posts the ante 70
kruiiser: posts the ante 70
baloobaloo00: posts the ante 70
miquelCdP: posts the ante 70
toitoitoi111: posts the ante 70
insomniac_jc: posts the ante 70
kruiiser: posts small blind 300
baloobaloo00: posts big blind 600
*** HOLE CARDS ***
Dealt to malik_msk [Ks 2c]
miquelCdP: folds 
toitoitoi111: folds 
insomniac_jc: folds 
Piton131313: folds 
Killererin: folds 
malik_msk: folds 
baztack: raises 14370 to 14970 and is all-in
kruiiser: folds 
baloobaloo00: calls 2626 and is all-in
Uncalled bet (11744) returned to baztack
*** FLOP *** [Td 7d 6c]
*** TURN *** [Td 7d 6c] [5c]
*** RIVER *** [Td 7d 6c 5c] [3s]
*** SHOW DOWN ***
baloobaloo00: shows [9c Tc] (a pair of Tens)
baztack: shows [Ts Th] (three of a kind, Tens)
baztack collected 7382 from pot
baloobaloo00 finished the tournament in 769th place
*** SUMMARY ***
Total pot 7382 | Rake 0 
Board [Td 7d 6c 5c 3s]
Seat 1: Piton131313 folded before Flop (didn't bet)
Seat 2: Killererin folded before Flop (didn't bet)
Seat 3: malik_msk folded before Flop (didn't bet)
Seat 4: baztack (button) showed [Ts Th] and won (7382) with three of a kind, Tens
Seat 5: kruiiser (small blind) folded before Flop
Seat 6: baloobaloo00 (big blind) showed [9c Tc] and lost with a pair of Tens
Seat 7: miquelCdP folded before Flop (didn't bet)
Seat 8: toitoitoi111 folded before Flop (didn't bet)
Seat 9: insomniac_jc folded before Flop (didn't bet)



PokerStars Game #70068621027: Tournament #545010286, $5.00+$0.50 USD Hold'em No Limit - Level XV (300/600) - 2011/11/05 19:39:42 MSK [2011/11/05 11:39:42 ET]
Table '545010286 77' 9-max Seat #5 is the button
Seat 1: Piton131313 (16040 in chips) 
Seat 2: Killererin (32516 in chips) 
Seat 3: malik_msk (26602 in chips) 
Seat 4: baztack (19126 in chips) 
Seat 5: kruiiser (13267 in chips) 
Seat 7: miquelCdP (30170 in chips) 
Seat 8: toitoitoi111 (13418 in chips) 
Seat 9: insomniac_jc (5742 in chips) 
Piton131313: posts the ante 70
Killererin: posts the ante 70
malik_msk: posts the ante 70
baztack: posts the ante 70
kruiiser: posts the ante 70
miquelCdP: posts the ante 70
toitoitoi111: posts the ante 70
insomniac_jc: posts the ante 70
miquelCdP: posts small blind 300
toitoitoi111: posts big blind 600
*** HOLE CARDS ***
Dealt to malik_msk [5h Js]
insomniac_jc: folds 
Piton131313: folds 
Killererin: raises 600 to 1200
malik_msk: folds 
baztack: folds 
kruiiser: calls 1200
miquelCdP: folds 
toitoitoi111: folds 
*** FLOP *** [4c Ad 3s]
Killererin: checks 
cookey00 is connected 
kruiiser: bets 1800
Killererin: raises 2400 to 4200
kruiiser: folds 
Uncalled bet (2400) returned to Killererin
Killererin collected 7460 from pot
Killererin: doesn't show hand 
*** SUMMARY ***
Total pot 7460 | Rake 0 
Board [4c Ad 3s]
Seat 1: Piton131313 folded before Flop (didn't bet)
Seat 2: Killererin collected (7460)
Seat 3: malik_msk folded before Flop (didn't bet)
Seat 4: baztack folded before Flop (didn't bet)
Seat 5: kruiiser (button) folded on the Flop
Seat 7: miquelCdP (small blind) folded before Flop
Seat 8: toitoitoi111 (big blind) folded before Flop
Seat 9: insomniac_jc folded before Flop (didn't bet)



PokerStars Game #70068655142: Tournament #545010286, $5.00+$0.50 USD Hold'em No Limit - Level XV (300/600) - 2011/11/05 19:40:25 MSK [2011/11/05 11:40:25 ET]
Table '545010286 77' 9-max Seat #7 is the button
Seat 1: Piton131313 (15970 in chips) 
Seat 2: Killererin (36906 in chips) 
Seat 3: malik_msk (26532 in chips) 
Seat 4: baztack (19056 in chips) 
Seat 5: kruiiser (10197 in chips) 
Seat 6: cookey00 (14134 in chips) 
Seat 7: miquelCdP (29800 in chips) 
Seat 8: toitoitoi111 (12748 in chips) 
Seat 9: insomniac_jc (5672 in chips) 
Piton131313: posts the ante 70
Killererin: posts the ante 70
malik_msk: posts the ante 70
baztack: posts the ante 70
kruiiser: posts the ante 70
cookey00: posts the ante 70
miquelCdP: posts the ante 70
toitoitoi111: posts the ante 70
insomniac_jc: posts the ante 70
toitoitoi111: posts small blind 300
insomniac_jc: posts big blind 600
*** HOLE CARDS ***
Dealt to malik_msk [8d 9h]
Piton131313: folds 
Killererin: folds 
malik_msk: calls 600
baztack: folds 
kruiiser: raises 9527 to 10127 and is all-in
cookey00: folds 
miquelCdP: folds 
toitoitoi111: folds 
insomniac_jc: folds 
malik_msk: calls 9527
*** FLOP *** [9d 6s Kc]
*** TURN *** [9d 6s Kc] [Kh]
*** RIVER *** [9d 6s Kc Kh] [7c]
*** SHOW DOWN ***
malik_msk: shows [8d 9h] (two pair, Kings and Nines)
kruiiser: shows [Kd Ad] (three of a kind, Kings)
kruiiser collected 21784 from pot
*** SUMMARY ***
Total pot 21784 | Rake 0 
Board [9d 6s Kc Kh 7c]
Seat 1: Piton131313 folded before Flop (didn't bet)
Seat 2: Killererin folded before Flop (didn't bet)
Seat 3: malik_msk showed [8d 9h] and lost with two pair, Kings and Nines
Seat 4: baztack folded before Flop (didn't bet)
Seat 5: kruiiser showed [Kd Ad] and won (21784) with three of a kind, Kings
Seat 6: cookey00 folded before Flop (didn't bet)
Seat 7: miquelCdP (button) folded before Flop (didn't bet)
Seat 8: toitoitoi111 (small blind) folded before Flop
Seat 9: insomniac_jc (big blind) folded before Flop



PokerStars Game #70068681215: Tournament #545010286, $5.00+$0.50 USD Hold'em No Limit - Level XV (300/600) - 2011/11/05 19:40:58 MSK [2011/11/05 11:40:58 ET]
Table '545010286 77' 9-max Seat #8 is the button
Seat 1: Piton131313 (15900 in chips) 
Seat 2: Killererin (36836 in chips) 
Seat 3: malik_msk (16335 in chips) 
Seat 4: baztack (18986 in chips) 
Seat 5: kruiiser (21784 in chips) 
Seat 6: cookey00 (14064 in chips) 
Seat 7: miquelCdP (29730 in chips) 
Seat 8: toitoitoi111 (12378 in chips) 
Seat 9: insomniac_jc (5002 in chips) 
Piton131313: posts the ante 70
Killererin: posts the ante 70
malik_msk: posts the ante 70
baztack: posts the ante 70
kruiiser: posts the ante 70
cookey00: posts the ante 70
miquelCdP: posts the ante 70
toitoitoi111: posts the ante 70
insomniac_jc: posts the ante 70
insomniac_jc: posts small blind 300
Piton131313: posts big blind 600
*** HOLE CARDS ***
Dealt to malik_msk [8d 6d]
Killererin: raises 600 to 1200
kruiiser said, "jesus"
malik_msk: calls 1200
baztack: folds 
kruiiser: folds 
cookey00: folds 
miquelCdP: folds 
malik_msk said, "nevermind :P"
toitoitoi111: folds 
insomniac_jc: folds 
Piton131313: raises 14630 to 15830 and is all-in
Killererin: folds 
malik_msk: calls 14630
*** FLOP *** [Jc Ac Qc]
*** TURN *** [Jc Ac Qc] [8c]
*** RIVER *** [Jc Ac Qc 8c] [7s]
*** SHOW DOWN ***
Piton131313: shows [Qs Qd] (three of a kind, Queens)
malik_msk: shows [8d 6d] (a pair of Eights)
kruiiser said, "nh"
Piton131313 collected 33790 from pot
*** SUMMARY ***
Total pot 33790 | Rake 0 
Board [Jc Ac Qc 8c 7s]
Seat 1: Piton131313 (big blind) showed [Qs Qd] and won (33790) with three of a kind, Queens
Seat 2: Killererin folded before Flop
Seat 3: malik_msk showed [8d 6d] and lost with a pair of Eights
Seat 4: baztack folded before Flop (didn't bet)
Seat 5: kruiiser folded before Flop (didn't bet)
Seat 6: cookey00 folded before Flop (didn't bet)
Seat 7: miquelCdP folded before Flop (didn't bet)
Seat 8: toitoitoi111 (button) folded before Flop (didn't bet)
Seat 9: insomniac_jc (small blind) folded before Flop



PokerStars Game #70068714549: Tournament #545010286, $5.00+$0.50 USD Hold'em No Limit - Level XV (300/600) - 2011/11/05 19:41:40 MSK [2011/11/05 11:41:40 ET]
Table '545010286 77' 9-max Seat #9 is the button
Seat 1: Piton131313 (33790 in chips) 
Seat 2: Killererin (35566 in chips) 
Seat 3: malik_msk (435 in chips) 
Seat 4: baztack (18916 in chips) 
Seat 5: kruiiser (21714 in chips) 
Seat 6: cookey00 (13994 in chips) 
Seat 7: miquelCdP (29660 in chips) 
Seat 8: toitoitoi111 (12308 in chips) 
Seat 9: insomniac_jc (4632 in chips) 
Piton131313: posts the ante 70
Killererin: posts the ante 70
malik_msk: posts the ante 70
baztack: posts the ante 70
kruiiser: posts the ante 70
cookey00: posts the ante 70
miquelCdP: posts the ante 70
toitoitoi111: posts the ante 70
insomniac_jc: posts the ante 70
Piton131313: posts small blind 300
Killererin: posts big blind 600
*** HOLE CARDS ***
Dealt to malik_msk [Qs 9h]
Piton131313 said, "donk"
malik_msk: calls 365 and is all-in
baztack: folds 
kruiiser: folds 
cookey00: folds 
miquelCdP: folds 
toitoitoi111: calls 600
insomniac_jc: folds 
Piton131313: raises 1320 to 1920
Killererin: raises 2880 to 4800
toitoitoi111: folds 
Piton131313: calls 2880
*** FLOP *** [7s 8s 5d]
Piton131313: checks 
Killererin: bets 4456
Piton131313: calls 4456
*** TURN *** [7s 8s 5d] [2s]
Piton131313: checks 
Killererin: checks 
*** RIVER *** [7s 8s 5d 2s] [Ad]
Piton131313: checks 
Killererin: bets 8888
Piton131313: calls 8888
*** SHOW DOWN ***
Killererin: shows [Jh As] (a pair of Aces)
Piton131313: mucks hand 
Killererin collected 35793 from side pot
malik_msk: mucks hand 
Killererin collected 2090 from main pot
malik_msk finished the tournament in 740th place
rainbow.july is connected 
*** SUMMARY ***
Total pot 37883 Main pot 2090. Side pot 35793. | Rake 0 
Board [7s 8s 5d 2s Ad]
Seat 1: Piton131313 (small blind) mucked [9c 9s]
Seat 2: Killererin (big blind) showed [Jh As] and won (37883) with a pair of Aces
Seat 3: malik_msk mucked [Qs 9h]
Seat 4: baztack folded before Flop (didn't bet)
Seat 5: kruiiser folded before Flop (didn't bet)
Seat 6: cookey00 folded before Flop (didn't bet)
Seat 7: miquelCdP folded before Flop (didn't bet)
Seat 8: toitoitoi111 folded before Flop
Seat 9: insomniac_jc (button) folded before Flop (didn't bet)



